In the early 2000"s, mewonkind's folly led to the breakdown of society and the restructuring of general cultural and technological vector-goals. At least that's what you were taught in data-download segment 2-histori-political info part 27A while syncing the standard edu-packets back in school. Now though, you find yourself inside of the massive hive known as CONvergence.

N is two.

Six is the magic number!

X is twelve!

Splounge-Dystopia
Watch your back, and don't let the cams spy your face. by Aaron Prust
Release 1 / Serial number 171206 / Inform 7 build 6M62 (I6/v6.33 lib 6/12N) SD

Space Lounge
You are in the Space Lounge, rumored to be the center of The Resistance. "Why did I come here?" you briefly wonder before looking around.

You can see an airlock, a black ninja outfit, a bar (on which are a Glowing Sphere and a glittery box (closed)), a bench, a chair, a bartender, AFrame, and a Security bot here.

You can go east through the airlock (closed) from here.

>look sphere
OOOOoooo glowy-sphere thingie! Its purple soft glow makes you feel safe and secure. It looks like there's some sort of helix-key as a component to the glowy-ness but it's unclear how you would remove it.

>take key
That seems to be a part of the Glowing Sphere.

>take sphere
That's fixed in place.

* * *

>actions
Actions listing on.

>open airlock
[opening the airlock]
(first unlocking the airlock)
[(1) unlocking keylessly the airlock - silently]
You lack a key that fits the airlock.
[(1) unlocking keylessly the airlock - silently - failed the check keylessly unlocking rule]

[opening the airlock - failed the check keylessly unlocking rule]

>look sphere
[examining the Glowing Sphere]
OOOOoooo glowy-sphere thingie! Its purple soft glow makes you feel safe and secure. It looks like there's some sort of helix-key as a component to the glowy-ness but it's unclear how you would remove it.

[examining the Glowing Sphere - succeeded]

>take key
[taking the security key]
That seems to be a part of the Glowing Sphere.
[taking the security key - failed the can't take component parts rule]

>take gun
You can't see any such thing.

>open box
[opening the glittery box]
You open the glittery box, revealing a security readout, a bowl, and a crazy looking gun.
[opening the glittery box - succeeded]

>take gun
[taking the crazy looking gun]
You have no idea what this gun does. You've never seen anything like it! You're pretty stoked to get this gun.

Taken.
[taking the crazy looking gun - succeeded]

>shoot self
(with the crazy looking gun)
[shooting yourself with the crazy looking gun]
That would be disastrous!
[shooting yourself with the crazy looking gun - failed the Check shooting something with something]

>shoot bar
(with the crazy looking gun)
[shooting the bar with the crazy looking gun]
ZAP! The bar twinkles out of existence! 

[shooting the bar with the crazy looking gun - succeeded]

>look
[looking]
Space Lounge
You are in the Space Lounge, rumored to be the center of The Resistance. "Why did I come here?" you briefly wonder before looking around.

You can see an airlock, a chair, a bench, and a bartender here.

[looking - succeeded]

>sit chair
I didn't understand that sentence.

>sit on chair
[entering the chair]
Oh boy this chair looks really soft and comfy! Ooooh ya you are totally gonna sit on this chair big time.

You sit down and are so comfortable - you could really get used to being in this chair.
[entering the chair - succeeded]

"What a lovely soft and dreamy world", you think. Nothing is wrong and everything is right. Right and soft. Sooooo sooooofffft.

>look
[looking]
Space Lounge (on the chair)
You are in the Space Lounge, rumored to be the center of The Resistance. "Why did I come here?" you briefly wonder before looking around.

You can see an airlock, a bench, and a bartender here.

[looking - succeeded]

"What a lovely soft and dreamy world", you think. Nothing is wrong and everything is right. Right and soft. Sooooo sooooofffft.

>get up
[exiting]
You'd rather be asleep.
[exiting - failed]

"What a lovely soft and dreamy world", you think. Nothing is wrong and everything is right. Right and soft. Sooooo sooooofffft.

>get up
[exiting]
You'd rather be asleep.
[exiting - failed]

"What a lovely soft and dreamy world", you think. Nothing is wrong and everything is right. Right and soft. Sooooo sooooofffft.

>stand
[exiting]
You'd rather be asleep.
[exiting - failed]

"What a lovely soft and dreamy world", you think. Nothing is wrong and everything is right. Right and soft. Sooooo sooooofffft.

>exit chair
I only understood you as far as wanting to exit.

>get out of chair
I only understood you as far as wanting to get outside.

>get up from chair
[getting off the chair]
You just can't get up, you are way too comfortable!
[getting off the chair - failed]

"What a lovely soft and dreamy world", you think. Nothing is wrong and everything is right. Right and soft. Sooooo sooooofffft.

>get up from chair
[getting off the chair]
You try to heave yourself up, but the soft lusciousness of the chair envelopes you and pulls you back into its comfy folds.
[getting off the chair - failed]

"What a lovely soft and dreamy world", you think. Nothing is wrong and everything is right. Right and soft. Sooooo sooooofffft.

>get up from chair
[getting off the chair]
[getting off the chair - failed]

"What a lovely soft and dreamy world", you think. Nothing is wrong and everything is right. Right and soft. Sooooo sooooofffft.

>get up from chair
[getting off the chair]
Whew! You just barely escaped that chair, it's so comfy you could get stuck in it forever!
[getting off the chair - succeeded]

>get up from chair
[getting off the chair]
But you aren't on the chair at the moment.
[getting off the chair - failed the can't get off things rule]

>sit on chair
[entering the chair]
Oh boy this chair looks really soft and comfy! Ooooh ya you are totally gonna sit on this chair big time.

"Hey Wait!" your subconscious jumps forth remembering the tempting softness - you decide not not to sit on that chair, it's so comfy you might never get up again!
[entering the chair - failed]

>sit on chair
[entering the chair]
Oh boy this chair looks really soft and comfy! Ooooh ya you are totally gonna sit on this chair big time.

"Hey Wait!" your subconscious jumps forth remembering the tempting softness - you decide not not to sit on that chair, it's so comfy you might never get up again!
[entering the chair - failed]

>sit on bench
[entering the bench]
You get onto the bench.

[entering the bench - succeeded]

>look
[looking]
Space Lounge (on the bench)
You are in the Space Lounge, rumored to be the center of The Resistance. "Why did I come here?" you briefly wonder before looking around.

You can see an airlock, a chair, and a bartender here.

[looking - succeeded]

>show me wig
[showing the wig to yourself]
[(1) examining the wig]
This wig is super shiny and silvery, reflecting light off in all directions, it helps you avoid being face-detected by the intero-pods.

[(1) examining the wig - succeeded]

[showing the wig to yourself - succeeded]

>undo
Space Lounge
[Previous turn undone.]

>look
[looking]
Space Lounge (on the bench)
You are in the Space Lounge, rumored to be the center of The Resistance. "Why did I come here?" you briefly wonder before looking around.

You can see an airlock, a chair, and a bartender here.

[looking - succeeded]

* * *

>aframe remove suit
That's not a verb I recognize.

>aframe, remove suit
AFrame takes off the pin-striped suit.

>take gun
You can't see any such thing.

>open box
You open the glittery box, revealing a security readout, a bowl, and a crazy looking gun.

>take gun
You have no idea what this gun does. You've never seen anything like it! You're pretty stoked to get this gun.

Taken.

>shoot aframe with gun
ZAP! AFrame twinkles out of existence!

* * *

>aframe, remove suit
He says "sure, anything for a laugh!"
AFrame takes off the pin-striped suit.

>look aframe
Aframe leans on a polystyrene pillar, wearing a pink thong with his usual aplomb.

>aframe, remove thong
AFrame takes off the pink thong.

>look
Space Lounge
You are in the Space Lounge, rumored to be the center of The Resistance. "Why did I come here?" you briefly wonder before looking around.

You can see an airlock, a bar (on which are a glittery box (closed) and a Glowing Sphere), a chair, a bench, a bartender, a black ninja outfit, and AFrame here.

You can go east through the airlock (closed) from here.

(From here, you can move to east.)

>look aframe
Aframe leans on a polystyrene pillar, wearing nothing with his usual aplomb.

>aframe put on thong
That's not a verb I recognize.

>aframe, wear thing
There is no reply.

>aframe, wear thong
AFrame puts on the pink thong.

>aframe, wear suit
AFrame puts on the pin-striped suit.

>look aframe
Aframe leans on a polystyrene pillar, wearing a pin-striped suit with his usual aplomb.

>talk aframe
That's not a verb I recognize.

>look
Space Lounge
You are in the Space Lounge, rumored to be the center of The Resistance. "Why did I come here?" you briefly wonder before looking around.

You can see an airlock, a bar (on which are a glittery box (closed) and a Glowing Sphere), a chair, a bench, a bartender, a black ninja outfit, and AFrame here.

You can go east through the airlock (closed) from here.

(From here, you can move to east.)

>e
(first opening the airlock)
(first unlocking the airlock)
You lack a key that fits the airlock.

* * *

>aframe, remove suit
He says "sure, anything for a laugh!"
AFrame takes off the pin-striped suit.

>open box
You open the glittery box, revealing a security readout, a bowl, and a crazy looking gun.

* * *

>take gun
You have no idea what this gun does. You've never seen anything like it! You're pretty stoked to get this gun.

Taken.

>shoot aframe
(with the crazy looking gun)
This weird ray comes out of your gun but it's like it's moving in slow-motion...as the beam wiggles toward Aframe super duper slow he steps out of the way of it. The wiggling intensifies and disappears. Aframe is looking at you with this annoyed look. Like he doesn't totally trust you anymore because you just tried to twinkle him out of existence.

>aframe, remove thong
He says "uhm I am not going to help you out because in case you forgot you tried to kill me. I don't even know why"

>ask aframe about xx
When you mention xx, Aframe's eyes light up. He smiles and looks around the room for a second before stepping closer to you. "How do you know aobut xx?", he says - well it doesn't matter now - just remember yy when you get to the zz okay? DON'T FORGET ABOUT THE YY! Then he looks around again and slowly fades from view, like all the color faded to grey, then all the outlines of his features just slowly alpha-faded to zero.

>look aframe
You can't see any such thing.

>e
(first opening the airlock)

Veranda Walkway
Outside the Space Lounge you look out into the larger Raditree Building to see the pool with under a high ceiling. Consuite lies beyond the pool in the main courtyard. Boffers beat each other up in the fenced in section of the courtyard. A floating dolphin surveillance pod floats by making you twitch instintively to make your shiny wig come between the camera and your face.

You can see an airlock, a black rod, and a floating dolphin (closed) here.

You can go north, northeast, northwest, southeast, west through the airlock to the Space Lounge, up, and down from here.

(From here, you can move to north, northeast, northwest, southeast, west, up, and down.)

>take rod
Taken.

>xyyxz
That's not a verb I recognize.

>w
Space Lounge
You are in the Space Lounge, rumored to be the center of The Resistance. "Why did I come here?" you briefly wonder before looking around.

You can see an airlock, a bar (on which are a glittery box (in which are a security readout and a bowl (in which is a note)) and a Glowing Sphere), a chair, a bench, a bartender, a black ninja outfit, and a Security bot here.

You can go east through the airlock to the Veranda Walkway from here.

(From here, you can move to east.)

>take note
Taken.

>read note
Cast the secret spell xyzzy

>cast xyzzy
you feel a whooshy sound enter your eyeball sockets and then your tummy flips over your groiny-place. WHOOOOOAAAA suddenly you find yourself trasported to the...

you feel a whooshy sound enter your eyeball sockets and then your tummy flips over your groiny-place. WHOOOOOAAAA suddenly you find yourself trasported to the...

Secret Room
You are in the Secret Room. DON'T TELL ANYONE YOU WERE EVER HERE! It's really dark, you can't see much.

You can see AFrame, a dolphin code, and a book here.

You can see no obvious exits.

(There are no routes out of this room.)

Under the influence of the black rod, you pronounced "xyzzy" as Xhi-zee. You understand now that the purpose of the black rod is to bring people here, to the Secret Room.

>look aframe
Aframe leans on a polystyrene pillar, wearing a pink thong with his usual aplomb.

>aframe, remove thong
He gives this double-wink thing - like winking with one eye twice then the other once then both at the same time then rolls his eyes up then blinks both eyes again. That's the secret code you know cause you're buds.
AFrame takes off the pink thong.

* * *

>aframe, take off suit
He says "sure, anything for a laugh!"
AFrame takes off the pin-striped suit.

>open box
You open the glittery box, revealing a security readout, a bowl, and a crazy looking gun.

* * *

>shoot aframe
(with the crazy looking gun)
This weird ray comes out of your gun but it's like it's moving in slow-motion...as the beam wiggles toward Aframe super duper slow he steps out of the way of it. The wiggling intensifies and disappears. Aframe is looking at you with this annoyed look. Like he doesn't totally trust you anymore because you just tried to twinkle him out of existence.

>aframe, take off thong
He says "uhm I am not going to help you out because in case you forgot you tried to kill me. I don't even know why"

>aframe xyzzy
I didn't understand that sentence.

>aframe, xx
There is no reply.

>ask aframe about xx
When you mention xx, Aframe's eyes light up. He smiles and looks around the room for a second before stepping closer to you. "How do you know aobut xx?", he says - well it doesn't matter now - just remember yy when you get to the zz okay? DON'T FORGET ABOUT THE YY! Then he looks around again and slowly fades from view, like all the color faded to grey, then all the outlines of his features just slowly alpha-fade to zero.

>aframe take off thong
I didn't understand that sentence.

* * *

>ask aframe about xx
When you mention xx, Aframe's eyes light up. He smiles and looks around the room for a second before stepping closer to you. "How do you know aobut xx?", he says - well it doesn't matter now - just remember yy when you get to the zz okay? DON'T FORGET ABOUT THE YY! Then he looks around again and slowly fades from view, like all the color faded to grey, then all the outlines of his features just slowly alpha-fade to zero.

>open box
You open the glittery box, revealing a security readout, a bowl, and a crazy looking gun.

* * *

>shoot aframe
(with the crazy looking gun)
This weird ray comes out of your gun but it's like it's moving in slow-motion...as the beam wiggles toward Aframe super duper slow he steps out of the way of it. The wiggling intensifies and disappears. Aframe is looking at you with this annoyed look. Like he doesn't totally trust you anymore because you just tried to twinkle him out of existence.

>take off suit
You aren't wearing the pin-striped suit.

>aframe, take off suit
He says "uhm I am not going to help you out because in case you forgot you tried to kill me. I don't even know why"

>ask aframe about xx
When you mention xx, Aframe's eyes light up. He smiles and looks around the room for a second before stepping closer to you. "How do you know aobut xx?", he says - well it doesn't matter now - just remember yy when you get to the zz okay? DON'T FORGET ABOUT THE YY! Then he looks around again and slowly fades from view, like all the color faded to grey, then all the outlines of his features just slowly alpha-fade to zero.

>aframe take off suit
I didn't understand that sentence.

>aframe, take off suit
He gives this double-wink thing - like winking with one eye twice then the other once then both at the same time then rolls his eyes up then blinks both eyes again. That's the secret code you know cause you're buds.
AFrame takes off the pin-striped suit.

* * *

>ask aframe xx
I didn't understand that sentence.

>aframe, xx
When you mention xx, Aframe's eyes light up. He smiles and looks around the room for a second before stepping closer to you. "How do you know aobut xx?", he says - well it doesn't matter now - just remember yy when you get to the zz okay? DON'T FORGET ABOUT THE YY! Then he looks around again and slowly fades from view, like all the color faded to grey, then all the outlines of his features just slowly alpha-fade to zero.

>ask aframe about xx
You can't see any such thing.

>xx aframe
That's not a verb I recognize.

* * *

>ask bartender about persians
"Hm, you've got me there," The bartender comments huskily.

>ask persians
You can't see any such thing.

>bartender, persians
"Sorry, I don't know much about that," The bartender replies.

* * *

>ask bartender about xx
"Sorry, I haven't the faintest," The bartender replies throatily.

* * *

>e
(first opening the airlock)

Veranda Walkway
Outside the Space Lounge you look out into the larger Raditree Building to see the pool with under a high ceiling. Consuite lies beyond the pool in the main courtyard. Boffers beat each other up in the fenced in section of the courtyard. A floating dolphin surveillance pod floats by making you twitch instintively to make your shiny wig come between the camera and your face.

You can see an airlock, a black rod, and a floating dolphin (closed) here.

You can go north, northeast, northwest, southeast, west through the airlock to the Space Lounge, up, and down from here.

>n
Floor Changer
Elevators, escalators, and stairwell.

You can go northeast, northwest, south to the Veranda Walkway, east, west, and down from here.

(From here, you can move to northeast, northwest, south, east, west, and down.)

>d
Lower Floor Changer
Lower elevators, escalators and stairwell lower level

You can go north, northeast, northwest, south, southwest, west, and up to the Floor Changer from here.

(From here, you can move to north, northeast, northwest, south, southwest, west, and up.)

>u
Floor Changer
Elevators, escalators, and stairwell.

You can go northeast, northwest, south to the Veranda Walkway, east, west, and down to the Lower Floor Changer from here.

(From here, you can move to northeast, northwest, south, east, west, and down.)

>u
You can't go that way.

>d
Lower Floor Changer
Lower elevators, escalators and stairwell lower level

You can go north, northeast, northwest, south, southwest, west, and up to the Floor Changer from here.

(From here, you can move to north, northeast, northwest, south, southwest, west, and up.)

>d
You can't go that way.

* * *

>n
Floor Changer
Elevators, escalators, and stairwell.

You can go northeast, northwest, south to the Veranda Walkway, east, west, and down from here.

(From here, you can move to northeast, northwest, south, east, west, and down.)

>w
Convergence Central
Convergence Central

You can go northeast, south, southwest, and east to the Floor Changer from here.

(From here, you can move to northeast, south, southwest, and east.)

>s
Mainstage
Mainstage

(From here, you can move to north.)

>n
Convergence Central
Convergence Central

(From here, you can move to south, southwest, and east.)

>sw
Dealer's Room
Dealer's Room

(From here, you can move to northeast.)

>ne
Convergence Central
Convergence Central

(From here, you can move to south, southwest, and east.)

>look
Convergence Central
Convergence Central

(From here, you can move to south, southwest, and east.)

>e
Floor Changer
Elevators, escalators, and stairwell.

(From here, you can move to northeast, northwest, south, east, west, and down.)

>ne
Stairwell Floor 2
Stairwell Floor 2

(From here, you can move to southwest and down.)

>sw
Floor Changer
Elevators, escalators, and stairwell.

(From here, you can move to northeast, northwest, south, east, west, and down.)

>nw
Upper Tower Connector
The Upper Tower Connector - connection between the short and tall towers.

(From here, you can move to southeast.)

* * *

>w
Convergence Central
Convergence Central

You can go northeast, south, southwest, and east to the Floor Changer from here.

(From here, you can move to northeast, south, southwest, and east.)

>sw
Dealer's Room
Dealer's Room

You can see a ninja costume here.

You can go northeast to Convergence Central from here.

(From here, you can move to northeast.)

>take costume
Taken.

>wear ninja costume
You put on the ninja costume.

>look self
As good-looking as ever.

* * *

>sw
Dealer's Room
Dealer's Room

You can see a ninja costume here.

You can go northeast to Convergence Central from here.

(From here, you can move to northeast.)

>take ninja
Taken.

>wear ninja
You put on the ninja costume.

>w
You can't go that way.

>s
You can't go that way.

>n
You can't go that way.

>e
You can't go that way.

>ne
Convergence Central
Convergence Central

You can go northeast, south, southwest to the Dealer's Room, and east to the Floor Changer from here.

(From here, you can move to northeast, south, southwest, and east.)

>look self
As good-looking as ever.

* * *

>sw
Dealer's Room
Dealer's Room

You can see a ninja costume here.

You can go northeast to Convergence Central from here.

(From here, you can move to northeast.)

>take ninja costume
Taken.

>wear ninja
You put on the ninja costume.

* * *

>take ninja costume
Taken.

>wear ninja costume
You can't wear that!

>put on ninja costume
You can't wear that!

* * *

>open box
You open the glittery box, revealing a security readout, a bowl, and a crazy looking gun.

* * *

>take gun
You have no idea what this gun does. You've never seen anything like it! You're pretty stoked to get this gun.

Taken.

>shoot sphere
(with the crazy looking gun)
ZAP! The Glowing Sphere twinkles out of existence! The security key clatters to the ground!

>take key
Taken.

>e
(first opening the airlock)
(first unlocking the airlock)
(with the security key)

Veranda Walkway
Outside the Space Lounge you look out into the larger Raditree Building to see the pool with under a high ceiling. Consuite lies beyond the pool in the main courtyard. Boffers beat each other up in the fenced in section of the courtyard. A floating dolphin surveillance pod floats by making you twitch instintively to make your shiny wig come between the camera and your face.

You can see an airlock, a black rod, and a floating dolphin (closed) here.

You can go north, northeast, northwest, southeast, west through the airlock to the Space Lounge, up, and down from here.

(From here, you can move to north, northeast, northwest, southeast, west, up, and down.)

>ne
Upper Northside Hallway
A hallway filled with freaks and nerds.

You can go south, southeast, southwest to the Veranda Walkway, and west from here.

(From here, you can move to south, southeast, southwest, and west.)

>se
Consuite
You can go northwest to the Upper Northside Hallway, southwest, and down from here.

(From here, you can move to northwest, southwest, and down.)

>nw
Upper Northside Hallway
A hallway filled with freaks and nerds.

You can go south, southeast to Consuite, southwest to the Veranda Walkway, and west from here.

(From here, you can move to south, southeast, southwest, and west.)

>s
Room 205
Room 205

You can go north to the Upper Northside Hallway from here.

(From here, you can move to north.)

* * *

>take gun
You have no idea what this gun does. You've never seen anything like it! You're pretty stoked to get this gun.

Taken.

>take readout
Taken.

>look bowl
The bowl is kind of unremarkable, not really exciting like some cool crazy gun would be or something.

In the bowl is a note.

>read note
Cast the secret spell xyzzy

>take note
Taken.

>xyzzy
You are unable to articulate the second "z" separately from the first, and the spell fails in a disdainful puff. If only you had the black rod.

* * *

>se
Upper Southside Hallway
This hallway is NUTS - there are signs everywhere and lights and sounds flashing. From this hallway you can get into a bunch of Party Rooms

You can go north, northeast, northwest to the Veranda Walkway, south, southeast, and southwest from here.

(From here, you can move to north, northeast, northwest, south, southeast, and southwest.)

>n
Room 233
Room 233

You can go south to the Upper Southside Hallway from here.

(From here, you can move to south.)

Round1
Welcome to Trivia, I'm your host, the disembodied voice coming from your device. We have only one rule; please don't cheat. Questions will be simple this round being worth five points a piece, but will increase in both difficulty and value as the game goes on. 

You can see no obvious exits.

(There are no routes out of this room.)

>k
I didn't understand that sentence.

>oka
I didn't understand that sentence.

>okay
I didn't understand that sentence.

* * *

>n
Room 233
Room 233

You can go south to the Upper Southside Hallway from here.

(From here, you can move to south.)

Round1
Welcome to Trivia, I'm your host, the disembodied voice coming from your device. We have only one rule; please don't cheat. Questions will be simple this round being worth five points a piece, but will increase in both difficulty and value as the game goes on. 

You can see no obvious exits.

(There are no routes out of this room.)

>s
Upper Southside Hallway
This hallway is NUTS - there are signs everywhere and lights and sounds flashing. From this hallway you can get into a bunch of Party Rooms

You can go north to Room 233, northeast, northwest to the Veranda Walkway, and south from here.

(From here, you can move to north, northeast, northwest, and south.)

* * *

>se
Upper Southside Hallway
This hallway is NUTS - there are signs everywhere and lights and sounds flashing. From this hallway you can get into a bunch of Party Rooms

You can go north, northeast, northwest to the Veranda Walkway, south, southeast, and southwest from here.

(From here, you can move to north, northeast, northwest, south, southeast, and southwest.)

>s
Staging Area
You can see a yellow jersey, a polkadot jersey, a green jersey, a white jersey, and a blue jersey here.

You can go north to the Upper Southside Hallway from here.

(From here, you can move to north.)

>look blue jersey
blue jersaaaay

* * *

>s
Staging Area
You can see a yellow jersey, a polkadot jersey, a green jersey, a white jersey, and a blue jersey here.

You can go north to the Upper Southside Hallway from here.

(From here, you can move to north.)

>look yellow jersey
Since 1919, the Tour de France has awarded this jersey to the race leader.

>look polkadot jersey
Since 1933, the Tour de France has awarded this jersey to the King of the Mountains.

>look green jersey
Since 1953, the Tour de France has awarded this jersey to the highest point scorer on sprints.

>look white jersey
Since 1975, the Tour de France has awarded this jersey to the best cyclist aged 25 or less.

* * *

>s
Staging Area
You can see a yellow jersey, a polkadot jersey, a green jersey, a white jersey, and a blue jersey here.

You can go north to the Upper Southside Hallway from here.

(From here, you can move to north.)

>n
Upper Southside Hallway
This hallway is NUTS - there are signs everywhere and lights and sounds flashing. From this hallway you can get into a bunch of Party Rooms

You can go north, northeast, northwest to the Veranda Walkway, south to the Staging Area, southeast, and southwest from here.

(From here, you can move to north, northeast, northwest, south, southeast, and southwest.)

>se
Round1
Welcome to Trivia, I'm your host, the disembodied voice coming from your device. We have only one rule; please don't cheat. Questions will be simple this round being worth five points a piece, but will increase in both difficulty and value as the game goes on. 

You can go northwest to the Upper Southside Hallway from here.

(From here, you can move to northwest.)

According to the Old Testament, who spent 3 days and nights in the belly of a whale?

Please enter your answer

>jonah
Incorrect. Next question.

The Soul and The Optima are both models by what auto make?

Please enter your answer

>sa
Incorrect. Next question.

Kim Jong Il, Joseph Stalin, or Mao Tsedong, which dictator ruled the longest?

Please enter your answer

>asd
Incorrect. Next question.

The Tom Green Show and 16 and Pregnant were originally aired on what network?

Please enter your answer

>asf
That was Round One, now onto Round Two!

Round2
Now onto Round Two where the questions get slightly harder but are worth ten points a piece.

You can see no obvious exits.

(There are no routes out of this room.)

Get a Mac was an ad slogan for what company from 2006 to 2009? 

Please enter your answer

>asdf
That was Round Two, now onto Round Three!

Round3
Round Three is here! The questions are harder but now worth fifteen points a piece.

You can see no obvious exits.

(There are no routes out of this room.)

The Original Ritz Hotel is located in what European City?

Please enter your answer

>as
That was Round Three, now onto Round Four!

Round4
This is it, the final round. Europe's The Final Countdown is now playing on loop in your head and the questions are worth a whopping twenty points a piece.

You can see no obvious exits.

(There are no routes out of this room.)

Double Think and Cold War are both terms created by what English Author?

Please enter your answer

>s
Incorrect. Next question.

What actor or actress was in X-Men the Last Stand, Inception, and Juno? 

Please enter your answer

>s
Incorrect. Next question.

CVX is the stock ticker symbol for what energy giant?

Please enter your answer

>s
Incorrect. Next question.

Spteznaz is an umbrella term for special forces from what country?

Please enter your answer

>s
Incorrect. That was the end of Round Four.

End
Final Score: 0/200

You can go northeast to the Upper Southside Hallway from here.

(From here, you can move to northeast.)

>look
End
Final Score: 0/200

You can go northeast to the Upper Southside Hallway from here.

(From here, you can move to northeast.)

>ne
Upper Southside Hallway
This hallway is NUTS - there are signs everywhere and lights and sounds flashing. From this hallway you can get into a bunch of Party Rooms

You can go north, northeast, northwest to the Veranda Walkway, south to the Staging Area, southeast to the Round1, and southwest to the End from here.

(From here, you can move to north, northeast, northwest, south, southeast, and southwest.)

* * *

>se
Upper Southside Hallway
This hallway is NUTS - there are signs everywhere and lights and sounds flashing. From this hallway you can get into a bunch of Party Rooms

You can go north, northeast, northwest to the Veranda Walkway, south, southeast, and southwest from here.

(From here, you can move to north, northeast, northwest, south, southeast, and southwest.)

>se
Round1
Welcome to Trivia, I'm your host, the disembodied voice coming from your device. We have only one rule; please don't cheat. Questions will be simple this round being worth five points a piece, but will increase in both difficulty and value as the game goes on. 

You can go northwest to the Upper Southside Hallway from here.

(From here, you can move to northwest.)

Kim Jong Il, Joseph Stalin, or Mao Tsedong, which dictator ruled the longest?

Please enter your answer

>Mao Tsedong
Well done.  Next question.

The Soul and The Optima are both models by what auto make?

Please enter your answer

>Kia
Well done.  Next question.

The Tom Green Show and 16 and Pregnant were originally aired on what network?

Please enter your answer

>d
Incorrect. Next question.

According to the Old Testament, who spent 3 days and nights in the belly of a whale?

Please enter your answer

>Jonah
That was Round One, now onto Round Two!

Round2
Now onto Round Two where the questions get slightly harder but are worth ten points a piece.

You can see no obvious exits.

(There are no routes out of this room.)

What movie has the Highland Games, a Witch, and Craig Ferguson as Lord Macintosh?

Please enter your answer

>Brave
Well done.  Next question.

In the contract version of what card game are players identified by points on the compass?

Please enter your answer

>Bridge
Well done.  Next question.

What is the capital of Egypt?

Please enter your answer

>Cairo
Well done.  Next question.

Get a Mac was an ad slogan for what company from 2006 to 2009? 

Please enter your answer

>Apple
That was Round Two, now onto Round Three where things get a bit more difficult!

Round3
Round Three is here! The questions are harder but now worth fifteen points a piece.

You can see no obvious exits.

(There are no routes out of this room.)

Ebony and Ivory was a duet performed by Stevie Wonder and what former Beatle?

Please enter your answer

I beg your pardon?

Please enter your answer

>d
That was Round Three, now onto Round Four!

Round4
This is it, the final round. Europe's The Final Countdown is now playing on loop in your head and the questions are worth a whopping twenty points a piece.

You can see no obvious exits.

(There are no routes out of this room.)

Spteznaz is an umbrella term for special forces from what country?

Please enter your answer

>Russia
Well done.  Next question.

CVX is the stock ticker symbol for what energy giant?

Please enter your answer

>Chevron
Well done.  Next question.

Double Think and Cold War are both terms created by what English Author?

Please enter your answer

>George Orwell
Well done.  Next question.

What actor or actress was in X-Men the Last Stand, Inception, and Juno? 

Please enter your answer

>Ellen Page
Well done. That was the end of Round Four.

End
Final Score: 135/200

You can go northeast to the Upper Southside Hallway from here.

(From here, you can move to northeast.)

I didn't understand that sentence.

>i
You're carrying a quizinator1 and a coin. You're wearing a wig.

[Your score has just gone up by one hundred thirty-five points.]

* * *

>se
Round1
Welcome to Trivia, I'm your host, the disembodied voice coming from your device. We have only one rule; please don't cheat. Questions will be simple this round being worth five points a piece, but will increase in both difficulty and value as the game goes on. 

You can go northwest to the Upper Southside Hallway from here.

(From here, you can move to northwest.)

Kim Jong Il, Joseph Stalin, or Mao Tsedong, which dictator ruled the longest?

Please enter your answer

>a
Incorrect. Next question.

According to the Old Testament, who spent 3 days and nights in the belly of a whale?

Please enter your answer

>asdf
Incorrect. Next question.

The Soul and The Optima are both models by what auto make?

Please enter your answer

>f
Incorrect. Next question.

The Tom Green Show and 16 and Pregnant were originally aired on what network?

Please enter your answer

>sdaf
That was Round One, now onto Round Two!

Round2
Now onto Round Two where the questions get slightly harder but are worth ten points a piece.

You can see no obvious exits.

(There are no routes out of this room.)

What movie has the Highland Games, a Witch, and Craig Ferguson as Lord Macintosh?

Please enter your answer

>df
That was Round Two, now onto Round Three!

Round3
Round Three is here! The questions are harder but now worth fifteen points a piece.

You can see no obvious exits.

(There are no routes out of this room.)

In what year did Spongebob Squarepants premier on television, Wide Open Spaces by the Dixie Chicks won a Grammy, and the Sixth Sense premiered in theaters?

Please enter your answer

>df
That was Round Three, now onto Round Four!

Round4
This is it, the final round. Europe's The Final Countdown is now playing on loop in your head and the questions are worth a whopping twenty points a piece.

You can see no obvious exits.

(There are no routes out of this room.)

Double Think and Cold War are both terms created by what English Author?

Please enter your answer

>George Orwell
Well done.  Next question.

Spteznaz is an umbrella term for special forces from what country?

Please enter your answer

>Russia
Well done.  Next question.

What actor or actress was in X-Men the Last Stand, Inception, and Juno? 

Please enter your answer

>Ellen Page
Well done.  Next question.

CVX is the stock ticker symbol for what energy giant?

Please enter your answer

>Chevron
Well done. That was the end of Round Four.

End
Final Score: 80/200

You can go northeast to the Upper Southside Hallway from here.

(From here, you can move to northeast.)

Please enter your answer

* * *

>se
Round1
Welcome to Trivia, I'm your host, the disembodied voice coming from your device. We have only one rule; please don't cheat. Questions will be simple this round being worth five points a piece, but will increase in both difficulty and value as the game goes on. 

You can go northwest to the Upper Southside Hallway from here.

(From here, you can move to northwest.)

Kim Jong Il, Joseph Stalin, or Mao Tsedong, which dictator ruled the longest?

Please enter your answer

>as
Incorrect. Next question.

The Tom Green Show and 16 and Pregnant were originally aired on what network?

Please enter your answer

>asdf
Incorrect. Next question.

Kim Jong Il, Joseph Stalin, or Mao Tsedong, which dictator ruled the longest?

Please enter your answer

>sad
Incorrect. Next question.

The Soul and The Optima are both models by what auto make?

Please enter your answer

>asfd
That was Round One, now onto Round Two!

Round2
Now onto Round Two where the questions get slightly harder but are worth ten points a piece.

You can see no obvious exits.

(There are no routes out of this room.)

What is the capital of Egypt?

Please enter your answer

>afsd
That was Round Two, now onto Round Three!

Round3
Round Three is here! The questions are harder but now worth fifteen points a piece.

You can see no obvious exits.

(There are no routes out of this room.)

The Original Ritz Hotel is located in what European City?

Please enter your answer

>fsad
That was Round Three, now onto Round Four!

Round4
This is it, the final round. Europe's The Final Countdown is now playing on loop in your head and the questions are worth a whopping twenty points a piece.

You can see no obvious exits.

(There are no routes out of this room.)

Double Think and Cold War are both terms created by what English Author?

Please enter your answer

I beg your pardon?

Please enter your answer

>fads
Incorrect. Next question.

CVX is the stock ticker symbol for what energy giant?

Please enter your answer

>asd
Incorrect. Next question.

What actor or actress was in X-Men the Last Stand, Inception, and Juno? 

Please enter your answer

>afsd
Incorrect. Next question.

Spteznaz is an umbrella term for special forces from what country?

Please enter your answer

>afsd
Incorrect. That was the end of Round Four.

End
Final Score: 0/200

You can go northeast to the Upper Southside Hallway from here.

(From here, you can move to northeast.)

>afsd
I didn't understand that sentence.

>asdf
I didn't understand that sentence.

* * *

>as
Incorrect. Next question.

The Tom Green Show and 16 and Pregnant were originally aired on what network?

Please enter your answer

>sf
Incorrect. Next question.

According to the Old Testament, who spent 3 days and nights in the belly of a whale?

Please enter your answer

>asdf
Incorrect. Next question.

The Tom Green Show and 16 and Pregnant were originally aired on what network?

Please enter your answer

>sfda
That was Round One, now onto Round Two!

Round2
Now onto Round Two where the questions get slightly harder but are worth ten points a piece.

You can see no obvious exits.

(There are no routes out of this room.)

In the contract version of what card game are players identified by points on the compass?

Please enter your answer

>asfd
That was Round Two, now onto Round Three!

Round3
Round Three is here! The questions are harder but now worth fifteen points a piece.

You can see no obvious exits.

(There are no routes out of this room.)

In what year did Spongebob Squarepants premier on television, Wide Open Spaces by the Dixie Chicks won a Grammy, and the Sixth Sense premiered in theaters?

Please enter your answer

>adfsf
That was Round Three, now onto Round Four!

Round4
This is it, the final round. Europe's The Final Countdown is now playing on loop in your head and the questions are worth a whopping twenty points a piece.

You can see no obvious exits.

(There are no routes out of this room.)

Double Think and Cold War are both terms created by what English Author?

Please enter your answer

>G
Incorrect. Next question.

What actor or actress was in X-Men the Last Stand, Inception, and Juno? 

Please enter your answer

>asdf
Incorrect. Next question.

Spteznaz is an umbrella term for special forces from what country?

Please enter your answer

>asdf
Incorrect. Next question.

CVX is the stock ticker symbol for what energy giant?

Please enter your answer

>asf
Incorrect. That was the end of Round Four.

End
Final Score: 0/200

You can go northeast to the Upper Southside Hallway from here.

(From here, you can move to northeast.)

I beg your pardon?

>ne
Upper Southside Hallway
This hallway is NUTS - there are signs everywhere and lights and sounds flashing. From this hallway you can get into a bunch of Party Rooms

You can go north, northeast, northwest to the Veranda Walkway, south, southeast to the Round1, and southwest to the End from here.

(From here, you can move to north, northeast, northwest, south, southeast, and southwest.)

* * *

>se
Round1
Welcome to Trivia, I'm your host, the disembodied voice coming from your device. We have only one rule; please don't cheat. Questions will be simple this round being worth five points a piece, but will increase in both difficulty and value as the game goes on. 

You can go northwest to the Upper Southside Hallway from here.

(From here, you can move to northwest.)

Kim Jong Il, Joseph Stalin, or Mao Tsedong, which dictator ruled the longest?

Please enter your answer

>asd
Incorrect. Next question.

According to the Old Testament, who spent 3 days and nights in the belly of a whale?

Please enter your answer

>asd
Incorrect. Next question.

Kim Jong Il, Joseph Stalin, or Mao Tsedong, which dictator ruled the longest?

Please enter your answer

>d
Incorrect. Next question.

The Tom Green Show and 16 and Pregnant were originally aired on what network?

Please enter your answer

I beg your pardon?

Please enter your answer

>d
That was Round One, now onto Round Two!

Round2
Now onto Round Two where the questions get slightly harder but are worth ten points a piece.

You can see no obvious exits.

(There are no routes out of this room.)

In the contract version of what card game are players identified by points on the compass?

Please enter your answer

>d
That was Round Two, now onto Round Three!

Round3
Round Three is here! The questions are harder but now worth fifteen points a piece.

You can see no obvious exits.

(There are no routes out of this room.)

In 1908, what Ford Model was first produced, eventually being named the Car of the Century?

Please enter your answer

>d
That was Round Three, now onto Round Four!

Round4
This is it, the final round. Europe's The Final Countdown is now playing on loop in your head and the questions are worth a whopping twenty points a piece.

You can see no obvious exits.

(There are no routes out of this room.)

Double Think and Cold War are both terms created by what English Author?

Please enter your answer

>d
Incorrect. Next question.

What actor or actress was in X-Men the Last Stand, Inception, and Juno? 

Please enter your answer

>d
Incorrect. Next question.

CVX is the stock ticker symbol for what energy giant?

Please enter your answer

>d
Incorrect. Next question.

Spteznaz is an umbrella term for special forces from what country?

Please enter your answer

>Russia
Well done. That was the end of Round Four.

End
Final Score: 20/200

You can go northeast to the Upper Southside Hallway from here.

(From here, you can move to northeast.)

Please enter your answer

>dk
Please enter your answer

>df
Please enter your answer

>quit
Please enter your answer

>e
Please enter your answer

* * *

>se
Round1
Welcome to Trivia, I'm your host, the disembodied voice coming from your device. We have only one rule; please don't cheat. Questions will be simple this round being worth five points a piece, but will increase in both difficulty and value as the game goes on. 

You can go northwest to the Upper Southside Hallway from here.

(From here, you can move to northwest.)

Kim Jong Il, Joseph Stalin, or Mao Tsedong, which dictator ruled the longest?

Please enter your answer

>d
Incorrect. Next question.

Kim Jong Il, Joseph Stalin, or Mao Tsedong, which dictator ruled the longest?

Please enter your answer

I beg your pardon?

Please enter your answer

I beg your pardon?

Please enter your answer

>dd
Incorrect. Next question.

Kim Jong Il, Joseph Stalin, or Mao Tsedong, which dictator ruled the longest?

Please enter your answer

>d
Incorrect. Next question.

According to the Old Testament, who spent 3 days and nights in the belly of a whale?

Please enter your answer

>d
That was Round One, now onto Round Two!

Round2
Now onto Round Two where the questions get slightly harder but are worth ten points a piece.

You can see no obvious exits.

(There are no routes out of this room.)

What is the capital of Egypt?

Please enter your answer

>d
That was Round Two, now onto Round Three!

Round3
Round Three is here! The questions are harder but now worth fifteen points a piece.

You can see no obvious exits.

(There are no routes out of this room.)

The Original Ritz Hotel is located in what European City?

Please enter your answer

>d
That was Round Three, now onto Round Four!

Round4
This is it, the final round. Europe's The Final Countdown is now playing on loop in your head and the questions are worth a whopping twenty points a piece.

You can see no obvious exits.

(There are no routes out of this room.)

Double Think and Cold War are both terms created by what English Author?

Please enter your answer

>d
Incorrect. Next question.

CVX is the stock ticker symbol for what energy giant?

Please enter your answer

* * *

>d
Incorrect. Next question.

Spteznaz is an umbrella term for special forces from what country?

Please enter your answer

>d
Incorrect. Next question.

What actor or actress was in X-Men the Last Stand, Inception, and Juno? 

Please enter your answer

>Ellen Page
Well done. That was the end of Round Four.

End
Final Score: 20/200

You can go northeast to the Upper Southside Hallway from here.

(From here, you can move to northeast.)

I didn't understand that sentence.

* * *

I beg your pardon?

Please enter your answer

>d
Incorrect. Next question.

According to the Old Testament, who spent 3 days and nights in the belly of a whale?

Please enter your answer

>d
Incorrect. Next question.

Kim Jong Il, Joseph Stalin, or Mao Tsedong, which dictator ruled the longest?

Please enter your answer

>d
That was Round One, now onto Round Two!

Round2
Now onto Round Two where the questions get slightly harder but are worth ten points a piece.

You can see no obvious exits.

(There are no routes out of this room.)

In the contract version of what card game are players identified by points on the compass?

Please enter your answer

>d
That was Round Two, now onto Round Three!

Round3
Round Three is here! The questions are harder but now worth fifteen points a piece.

You can see no obvious exits.

(There are no routes out of this room.)

In what year did Spongebob Squarepants premier on television, Wide Open Spaces by the Dixie Chicks won a Grammy, and the Sixth Sense premiered in theaters?

Please enter your answer

>d
That was Round Three, now onto Round Four!

Round4
This is it, the final round. Europe's The Final Countdown is now playing on loop in your head and the questions are worth a whopping twenty points a piece.

You can see no obvious exits.

(There are no routes out of this room.)

What actor or actress was in X-Men the Last Stand, Inception, and Juno? 

Please enter your answer

>d
Incorrect. Next question.

Double Think and Cold War are both terms created by what English Author?

Please enter your answer

>d
Incorrect. Next question.

CVX is the stock ticker symbol for what energy giant?

Please enter your answer

* * *

>d
Incorrect. Next question.

Spteznaz is an umbrella term for special forces from what country?

Please enter your answer

>d
Incorrect. That was the end of Round Four.

End
Final Score: 0/200

You can go northeast to the Upper Southside Hallway from here.

(From here, you can move to northeast.)

* * *

>d
Incorrect. Next question.

Kim Jong Il, Joseph Stalin, or Mao Tsedong, which dictator ruled the longest?

Please enter your answer

>d
Incorrect. Next question.

The Soul and The Optima are both models by what auto make?

Please enter your answer

I beg your pardon?

Please enter your answer

>d
Incorrect. Next question.

Kim Jong Il, Joseph Stalin, or Mao Tsedong, which dictator ruled the longest?

Please enter your answer

>d
That was Round One, now onto Round Two!

Round2
Now onto Round Two where the questions get slightly harder but are worth ten points a piece.

You can see no obvious exits.

(There are no routes out of this room.)

>d
You can't go that way.

>d
You can't go that way.

>d
Incorrect. Next question.

What actor or actress was in X-Men the Last Stand, Inception, and Juno? 

Please enter your answer

* * *

>d
Incorrect. Next question.

CVX is the stock ticker symbol for what energy giant?

Please enter your answer

>d
Incorrect. Next question.

Double Think and Cold War are both terms created by what English Author?

Please enter your answer

>George Orwell
Well done. That was the end of Round Four.

End
Final Score: 20/200

You can go northeast to the Upper Southside Hallway from here.

(From here, you can move to northeast.)

Please enter your answer

* * *

>d
Incorrect. Next question.

The Soul and The Optima are both models by what auto make?

Please enter your answer

>d
Incorrect. Next question.

According to the Old Testament, who spent 3 days and nights in the belly of a whale?

Please enter your answer

I beg your pardon?

Please enter your answer

>d
That was Round One, now onto Round Two!

Round2
Now onto Round Two where the questions get slightly harder but are worth ten points a piece.

You can see no obvious exits.

(There are no routes out of this room.)

What movie has the Highland Games, a Witch, and Craig Ferguson as Lord Macintosh?

Please enter your answer

>d
That was Round Two, now onto Round Three!

Round3
Round Three is here! The questions are harder but now worth fifteen points a piece.

You can see no obvious exits.

(There are no routes out of this room.)

Ebony and Ivory was a duet performed by Stevie Wonder and what former Beatle?

Please enter your answer

>d
That was Round Three, now onto Round Four!

Round4
This is it, the final round. Europe's The Final Countdown is now playing on loop in your head and the questions are worth a whopping twenty points a piece.

You can see no obvious exits.

(There are no routes out of this room.)

CVX is the stock ticker symbol for what energy giant?

Please enter your answer

>d
Incorrect. Next question.

What actor or actress was in X-Men the Last Stand, Inception, and Juno? 

Please enter your answer

>d
Incorrect. Next question.

Spteznaz is an umbrella term for special forces from what country?

Please enter your answer

>Russia
Well done.  Next question.

Double Think and Cold War are both terms created by what English Author?

Please enter your answer

>George Orwell
Well done. That was the end of Round Four.

End
Final Score: 40/200

You can go northeast to the Upper Southside Hallway from here.

(From here, you can move to northeast.)

Please enter your answer

* * *

>d
That was Round One, now onto Round Two!

Round2
Now onto Round Two where the questions get slightly harder but are worth ten points a piece.

You can see no obvious exits.

(There are no routes out of this room.)

What is the capital of Egypt?

Please enter your answer

>d
That was Round Two, now onto Round Three!

Round3
Round Three is here! The questions are harder but now worth fifteen points a piece.

You can see no obvious exits.

(There are no routes out of this room.)

Ebony and Ivory was a duet performed by Stevie Wonder and what former Beatle?

Please enter your answer

>d
That was Round Three, now onto Round Four!

Round4
This is it, the final round. Europe's The Final Countdown is now playing on loop in your head and the questions are worth a whopping twenty points a piece.

You can see no obvious exits.

(There are no routes out of this room.)

What actor or actress was in X-Men the Last Stand, Inception, and Juno? 

Please enter your answer

* * *

>d
Incorrect. Next question.

Double Think and Cold War are both terms created by what English Author?

Please enter your answer

>Chevron
Well done.  Next question.

Spteznaz is an umbrella term for special forces from what country?

Please enter your answer

>Russia
Well done.  Next question.

What actor or actress was in X-Men the Last Stand, Inception, and Juno? 

Please enter your answer

>Ellen Page
Well done. That was the end of Round Four.

End
Final Score: 60/200

You can go northeast to the Upper Southside Hallway from here.

(From here, you can move to northeast.)

Please enter your answer

* * *

>d
Incorrect. Next question.

Double Think and Cold War are both terms created by what English Author?

Please enter your answer

>d
Incorrect. Next question.

Spteznaz is an umbrella term for special forces from what country?

Please enter your answer

>Chevron
Well done.  Next question.

Spteznaz is an umbrella term for special forces from what country?

Please enter your answer

>Russia
Well done. That was the end of Round Four.

End
Final Score: 40/200

You can go northeast to the Upper Southside Hallway from here.

(From here, you can move to northeast.)

Please enter your answer

* * *

>d
Incorrect. Next question.

Spteznaz is an umbrella term for special forces from what country?

Please enter your answer

>d
Incorrect. Next question.

CVX is the stock ticker symbol for what energy giant?

Please enter your answer

>Chevron
Well done. That was the end of Round Four.

End
Final Score: 20/200

You can go northeast to the Upper Southside Hallway from here.

(From here, you can move to northeast.)

I didn't understand that sentence.

>ads
Please enter your answer

* * *

>Chevron
Well done. That was the end of Round Four.

End
Final Score: 20/200

You can go northeast to the Upper Southside Hallway from here.

(From here, you can move to northeast.)

I didn't understand that sentence.

>i
You're carrying a quizinator2 and a coin. You're wearing a wig.

[Your score has just gone up by twenty points.]

>look quizinator2
You got this for bad quizinating.

* * *

>d
Incorrect. Next question.

CVX is the stock ticker symbol for what energy giant?

Please enter your answer

>George Orwell
Well done. That was the end of Round Four.

End
Final Score: 20/200

You can go northeast to the Upper Southside Hallway from here.

(From here, you can move to northeast.)

I didn't understand that sentence.

>i
You're carrying a quizinator1 and a coin. You're wearing a wig.

[Your score has just gone up by twenty points.]

>look quizinator1
You got this for good quizinating!

* * *

>d
Incorrect. Next question.

CVX is the stock ticker symbol for what energy giant?

Please enter your answer

>Russia
Well done. That was the end of Round Four.

End
Final Score: 20/200

You can go northeast to the Upper Southside Hallway from here.

(From here, you can move to northeast.)

Please enter your answer

* * *

>se
Round1
Welcome to Trivia, I'm your host, the disembodied voice coming from your device. We have only one rule; please don't cheat. Questions will be simple this round being worth five points a piece, but will increase in both difficulty and value as the game goes on. 

You can go northwest to the Upper Southside Hallway from here.

(From here, you can move to northwest.)

Kim Jong Il, Joseph Stalin, or Mao Tsedong, which dictator ruled the longest?

Please enter your answer

>e
Incorrect. Next question.

According to the Old Testament, who spent 3 days and nights in the belly of a whale?

Please enter your answer

>e
Incorrect. Next question.

The Soul and The Optima are both models by what auto make?

Please enter your answer

>e
Incorrect. Next question.

The Tom Green Show and 16 and Pregnant were originally aired on what network?

Please enter your answer

>e
That was Round One, now onto Round Two!

Round2
Now onto Round Two where the questions get slightly harder but are worth ten points a piece.

You can see no obvious exits.

(There are no routes out of this room.)

What movie has the Highland Games, a Witch, and Craig Ferguson as Lord Macintosh?

Please enter your answer

>e
That was Round Two, now onto Round Three!

Round3
Round Three is here! The questions are harder but now worth fifteen points a piece.

You can see no obvious exits.

(There are no routes out of this room.)

In 1908, what Ford Model was first produced, eventually being named the Car of the Century?

Please enter your answer

>e
That was Round Three, now onto Round Four!

Round4
This is it, the final round. Europe's The Final Countdown is now playing on loop in your head and the questions are worth a whopping twenty points a piece.

You can see no obvious exits.

(There are no routes out of this room.)

CVX is the stock ticker symbol for what energy giant?

Please enter your answer

>e
Incorrect. Next question.

What actor or actress was in X-Men the Last Stand, Inception, and Juno? 

Please enter your answer

>e
Incorrect. Next question.

Double Think and Cold War are both terms created by what English Author?

Please enter your answer

>e
Incorrect. Next question.

Spteznaz is an umbrella term for special forces from what country?

Please enter your answer

>Chevron
Well done. That was the end of Round Four.

End
Final Score: 20/200

You can go northeast to the Upper Southside Hallway from here.

(From here, you can move to northeast.)

Please enter your answer

* * *

>e
Incorrect. Next question.

Spteznaz is an umbrella term for special forces from what country?

Please enter your answer

>f
Incorrect. That was the end of Round Four.

End
Final Score: 0/200

You can go northeast to the Upper Southside Hallway from here.

(From here, you can move to northeast.)

* * *

>se
Round1
Welcome to Trivia, I'm your host, the disembodied voice coming from your device. We have only one rule; please don't cheat. Questions will be simple this round being worth five points a piece, but will increase in both difficulty and value as the game goes on. 

You can go northwest to the Upper Southside Hallway from here.

(From here, you can move to northwest.)

Kim Jong Il, Joseph Stalin, or Mao Tsedong, which dictator ruled the longest?

Please enter your answer

>kia
Incorrect. Next question.

Kim Jong Il, Joseph Stalin, or Mao Tsedong, which dictator ruled the longest?

Please enter your answer

>Mao Tsedong
Well done.  Next question.

The Tom Green Show and 16 and Pregnant were originally aired on what network?

Please enter your answer

>MTV
Well done.  Next question.

According to the Old Testament, who spent 3 days and nights in the belly of a whale?

Please enter your answer

>Jonah
That was Round One, now onto Round Two!

Round2
Now onto Round Two where the questions get slightly harder but are worth ten points a piece.

You can see no obvious exits.

(There are no routes out of this room.)

Get a Mac was an ad slogan for what company from 2006 to 2009? 

Please enter your answer

>Apple
Well done.  Next question.

In the contract version of what card game are players identified by points on the compass?

Please enter your answer

>Bridge
Well done.  Next question.

What is the capital of Egypt?

Please enter your answer

>Cairo
Well done.  Next question.

What movie has the Highland Games, a Witch, and Craig Ferguson as Lord Macintosh?

Please enter your answer

>Brave
That was Round Two, now onto Round Three where things get a bit more difficult!

Round3
Round Three is here! The questions are harder but now worth fifteen points a piece.

You can see no obvious exits.

(There are no routes out of this room.)

Ebony and Ivory was a duet performed by Stevie Wonder and what former Beatle?

Please enter your answer

>Paul McCartney
Well done.  Next question.

In 1908, what Ford Model was first produced, eventually being named the Car of the Century?

Please enter your answer

>Model T
Well done.  Next question.

In what year did Spongebob Squarepants premier on television, Wide Open Spaces by the Dixie Chicks won a Grammy, and the Sixth Sense premiered in theaters?

Please enter your answer

>1999
Well done.  Next question.

The Original Ritz Hotel is located in what European City?

Please enter your answer

>Paris
That was Round Three, now onto Round Four!

Round4
This is it, the final round. Europe's The Final Countdown is now playing on loop in your head and the questions are worth a whopping twenty points a piece.

You can see no obvious exits.

(There are no routes out of this room.)

What actor or actress was in X-Men the Last Stand, Inception, and Juno? 

Please enter your answer

>Ellen Page
Well done.  Next question.

Spteznaz is an umbrella term for special forces from what country?

Please enter your answer

>Russia
Well done.  Next question.

CVX is the stock ticker symbol for what energy giant?

Please enter your answer

* * *

>Chevron
Well done.  Next question.

Double Think and Cold War are both terms created by what English Author?

Please enter your answer

>George Orwell
Well done. That was the end of Round Four.

End
Final Score: 195/200

You can go northeast to the Upper Southside Hallway from here.

(From here, you can move to northeast.)

Please enter your answer

* * *

>se
Round1
Welcome to Trivia, I'm your host, the disembodied voice coming from your device. We have only one rule; please don't cheat. Questions will be simple this round being worth five points a piece, but will increase in both difficulty and value as the game goes on. 

You can go northwest to the Upper Southside Hallway from here.

(From here, you can move to northwest.)

Kim Jong Il, Joseph Stalin, or Mao Tsedong, which dictator ruled the longest?

Please enter your answer

>mao
Incorrect. Next question.

The Soul and The Optima are both models by what auto make?

Please enter your answer

>tesla
Incorrect. Next question.

According to the Old Testament, who spent 3 days and nights in the belly of a whale?

Please enter your answer

>f
Incorrect. Next question.

The Tom Green Show and 16 and Pregnant were originally aired on what network?

Please enter your answer

>a
That was Round One, now onto Round Two!

Round2
Now onto Round Two where the questions get slightly harder but are worth ten points a piece.

You can see no obvious exits.

(There are no routes out of this room.)

What movie has the Highland Games, a Witch, and Craig Ferguson as Lord Macintosh?

Please enter your answer

>asdf
That was Round Two, now onto Round Three!

Round3
Round Three is here! The questions are harder but now worth fifteen points a piece.

You can see no obvious exits.

(There are no routes out of this room.)

Ebony and Ivory was a duet performed by Stevie Wonder and what former Beatle?

Please enter your answer

>adsf
That was Round Three, now onto Round Four!

Round4
This is it, the final round. Europe's The Final Countdown is now playing on loop in your head and the questions are worth a whopping twenty points a piece.

You can see no obvious exits.

(There are no routes out of this room.)

What actor or actress was in X-Men the Last Stand, Inception, and Juno? 

Please enter your answer

>adsf
Incorrect. Next question.

CVX is the stock ticker symbol for what energy giant?

Please enter your answer

>f
Incorrect. Next question.

Double Think and Cold War are both terms created by what English Author?

Please enter your answer

>f
Incorrect. Next question.

Spteznaz is an umbrella term for special forces from what country?

Please enter your answer

>f
Incorrect. That was the end of Round Four.

End
Final Score: 0/200

You can see no obvious exits.

(There are no routes out of this room.)

* * *

>se
Round1
Welcome to Trivia, I'm your host, the disembodied voice coming from your device. We have only one rule; please don't cheat. Questions will be simple this round being worth five points a piece, but will increase in both difficulty and value as the game goes on. 

You can go northwest to the Upper Southside Hallway from here.

(From here, you can move to northwest.)

Kim Jong Il, Joseph Stalin, or Mao Tsedong, which dictator ruled the longest?

Please enter your answer

>s
Incorrect. Next question.

According to the Old Testament, who spent 3 days and nights in the belly of a whale?

Please enter your answer

I beg your pardon?

Please enter your answer

>sdf
Incorrect. Next question.

Kim Jong Il, Joseph Stalin, or Mao Tsedong, which dictator ruled the longest?

Please enter your answer

>df
Incorrect. Next question.

The Soul and The Optima are both models by what auto make?

Please enter your answer

>asdf
That was Round One, now onto Round Two!

Round2
Now onto Round Two where the questions get slightly harder but are worth ten points a piece.

You can see no obvious exits.

(There are no routes out of this room.)

What is the capital of Egypt?

Please enter your answer

>asdf
That was Round Two, now onto Round Three!

Round3
Round Three is here! The questions are harder but now worth fifteen points a piece.

You can see no obvious exits.

(There are no routes out of this room.)

In what year did Spongebob Squarepants premier on television, Wide Open Spaces by the Dixie Chicks won a Grammy, and the Sixth Sense premiered in theaters?

Please enter your answer

>fd
That was Round Three, now onto Round Four!

Round4
This is it, the final round. Europe's The Final Countdown is now playing on loop in your head and the questions are worth a whopping twenty points a piece.

You can see no obvious exits.

(There are no routes out of this room.)

What actor or actress was in X-Men the Last Stand, Inception, and Juno? 

Please enter your answer

>df
Incorrect. Next question.

Spteznaz is an umbrella term for special forces from what country?

Please enter your answer

>df
Incorrect. Next question.

CVX is the stock ticker symbol for what energy giant?

Please enter your answer

>df
Incorrect. Next question.

Double Think and Cold War are both terms created by what English Author?

Please enter your answer

>df
Incorrect. That was the end of Round Four.

End
Final Score: 0/200

You can go northeast to the Upper Southside Hallway from here.

(From here, you can move to northeast.)

>n
You can't go that way.

>ne
Upper Southside Hallway
This hallway is NUTS - there are signs everywhere and lights and sounds flashing. From this hallway you can get into a bunch of Party Rooms

You can go north, northeast, northwest to the Veranda Walkway, south, southeast to the Round1, and southwest to the End from here.

(From here, you can move to north, northeast, northwest, south, southeast, and southwest.)

* * *

>se
Upper Southside Hallway
This hallway is NUTS - there are signs everywhere and lights and sounds flashing. From this hallway you can get into a bunch of Party Rooms

You can go north, northeast, northwest to the Veranda Walkway, south, southeast, and southwest from here.

(From here, you can move to north, northeast, northwest, south, southeast, and southwest.)

>sw
End
Final Score: 0/200

You can go northeast to the Upper Southside Hallway from here.

(From here, you can move to northeast.)

>ne
Upper Southside Hallway
This hallway is NUTS - there are signs everywhere and lights and sounds flashing. From this hallway you can get into a bunch of Party Rooms

You can go north, northeast, northwest to the Veranda Walkway, south, southeast, and southwest to the End from here.

(From here, you can move to north, northeast, northwest, south, southeast, and southwest.)

>se
Round1
Welcome to Trivia, I'm your host, the disembodied voice coming from your device. We have only one rule; please don't cheat. Questions will be simple this round being worth five points a piece, but will increase in both difficulty and value as the game goes on. 

You can go northwest to the Upper Southside Hallway from here.

(From here, you can move to northwest.)

According to the Old Testament, who spent 3 days and nights in the belly of a whale?

Please enter your answer

>d
Incorrect. Next question.

The Tom Green Show and 16 and Pregnant were originally aired on what network?

Please enter your answer

* * *

>d
Incorrect. Next question.

Kim Jong Il, Joseph Stalin, or Mao Tsedong, which dictator ruled the longest?

Please enter your answer

>f
Incorrect. Next question.

The Soul and The Optima are both models by what auto make?

Please enter your answer

>asdf
That was Round One, now onto Round Two!

Round2
Now onto Round Two where the questions get slightly harder but are worth ten points a piece.

You can see no obvious exits.

(There are no routes out of this room.)

What movie has the Highland Games, a Witch, and Craig Ferguson as Lord Macintosh?

Please enter your answer

>adsf
That was Round Two, now onto Round Three!

Round3
Round Three is here! The questions are harder but now worth fifteen points a piece.

You can see no obvious exits.

(There are no routes out of this room.)

In 1908, what Ford Model was first produced, eventually being named the Car of the Century?

Please enter your answer

>ads
That was Round Three, now onto Round Four!

Round4
This is it, the final round. Europe's The Final Countdown is now playing on loop in your head and the questions are worth a whopping twenty points a piece.

You can see no obvious exits.

(There are no routes out of this room.)

What actor or actress was in X-Men the Last Stand, Inception, and Juno? 

Please enter your answer

>aa
Incorrect. Next question.

Spteznaz is an umbrella term for special forces from what country?

Please enter your answer

>f
Incorrect. Next question.

CVX is the stock ticker symbol for what energy giant?

Please enter your answer

>f
Incorrect. Next question.

Double Think and Cold War are both terms created by what English Author?

Please enter your answer

>s
Incorrect. That was the end of Round Four.

End
Final Score: 0/200

You can go northeast to the Upper Southside Hallway from here.

(From here, you can move to northeast.)

>ne
Upper Southside Hallway
This hallway is NUTS - there are signs everywhere and lights and sounds flashing. From this hallway you can get into a bunch of Party Rooms

You can go north, northeast, northwest to the Veranda Walkway, south, southeast to the Round1, and southwest to the End from here.

(From here, you can move to north, northeast, northwest, south, southeast, and southwest.)

>s
Staging Area
You can see a yellow jersey, a polkadot jersey, a green jersey, a white jersey, and a blue jersey here.

You can go north to the Upper Southside Hallway from here.

(From here, you can move to north.)

>look yellow
Since 1919, the Tour de France has awarded this jersey to the race leader.

>look pokadot
You can't see any such thing.

>look polkadot
Since 1933, the Tour de France has awarded this jersey to the King of the Mountains.

>look green
Since 1953, the Tour de France has awarded this jersey to the highest point scorer on sprints.

>look white
Since 1975, the Tour de France has awarded this jersey to the best cyclist aged 25 or less.

>look blue
blue jersaaaay

* * *

>sw
You can't go that way.

>se
Upper Southside Hallway
This hallway is NUTS - there are signs everywhere and lights and sounds flashing. From this hallway you can get into a bunch of Party Rooms

You can go north, northeast, northwest to the Veranda Walkway, and south from here.

(From here, you can move to north, northeast, northwest, and south.)

>s
Staging Area
You can see a yellow jersey, a polkadot jersey, a green jersey, a white jersey, and a blue jersey here.

You can go north to the Upper Southside Hallway from here.

(From here, you can move to north.)

* * *

>w
Space Lounge
You are in the Space Lounge, rumored to be the center of The Resistance. "Why did I come here?" you briefly wonder before looking around.

You can see an airlock, a bar (on which are a glittery box (closed) and a Glowing Sphere), a chair, a bench, and a bartender here.

(From here, you can move to east.)

>open box
You open the glittery box, revealing a security readout, a bowl, and a crazy looking gun.

>take readout
Taken.

>take bown
You can't see any such thing.

>look bowl
The bowl is kind of unremarkable, not really exciting like some cool crazy gun would be or something.

In the bowl is a note.

>look note
Cast the secret spell xyzzy

>xyzzy
You are unable to articulate the second "z" separately from the first, and the spell fails in a disdainful puff. If only you had the black rod.

>take note
Taken.

>take gun
You have no idea what this gun does. You've never seen anything like it! You're pretty stoked to get this gun.

Taken.

>look sphere
OOOOoooo glowy-sphere thingie! Its purple soft glow makes you feel safe and secure. It looks like there's some sort of helix-key as a component to the glowy-ness but it's unclear how you would remove it.

* * *

>take key
That seems to be a part of the Glowing Sphere.

>shoot sphere with gun
ZAP! The Glowing Sphere twinkles out of existence! The security key clatters to the ground!

>take key
Taken.

>look readout
The screen is blank.

The security readout is currently switched off.

>turn on readout
You switch the security readout on.

>look readout
The screen reads: 

 airlock (Space Lounge/Veranda Walkway): UNLOCKED

>lock airlock
(first closing the airlock)
(with the security key)
You lock the airlock.

>w
You can't go that way.

>e
(first opening the airlock)
(first unlocking the airlock)
(with the security key)

Veranda Walkway
Outside the Space Lounge you look out into the larger Raditree Building to see the pool with under a high ceiling. Consuite lies beyond the pool in the main courtyard. Boffers beat each other up in the fenced in section of the courtyard. A floating dolphin surveillance pod floats by making you twitch instintively to make your shiny wig come between the camera and your face.

You can see an airlock, a black rod, and a floating dolphin (closed) here.

(From here, you can move to north, northeast, northwest, southeast, west, up, and down.)

>w
Space Lounge
You are in the Space Lounge, rumored to be the center of The Resistance. "Why did I come here?" you briefly wonder before looking around.

You can see an airlock, a bar (on which is a glittery box (in which is a bowl (empty))), a chair, a bench, and a bartender here.

(From here, you can move to east.)

>e
Veranda Walkway
Outside the Space Lounge you look out into the larger Raditree Building to see the pool with under a high ceiling. Consuite lies beyond the pool in the main courtyard. Boffers beat each other up in the fenced in section of the courtyard. A floating dolphin surveillance pod floats by making you twitch instintively to make your shiny wig come between the camera and your face.

You can see an airlock, a black rod, and a floating dolphin (closed) here.

(From here, you can move to north, northeast, northwest, southeast, west, up, and down.)

>open dolphin
(first unlocking the floating dolphin)
You lack a key that fits the floating dolphin.

>u
You don't have wings or pyscho-kinetic levitation abilities or a hoverboard or anything to go up with.

>d
Under the Veranda Walkway
Under the Veranda Walkway

(From here, you can move to north, northeast, southeast, east, west, and up.)

* * *

>enter chair
Oh boy this chair looks really soft and comfy! Ooooh ya you are totally gonna sit on this chair big time.

You sit down and are so comfortable - you could really get used to being in this chair. Really! Wowsers...it's just the comfiest thing you probably ever plopped yer can on...it's like you're almost part of this thing...like your skin is melding with it and your insides are turning to some sort of tiny little beans...or a kind of foam batting material...

"What a lovely soft and dreamy world", you think. Nothing is wrong and everything is right. Right and soft. Sooooo sooooofffft.

>exit chair
I only understood you as far as wanting to exit.

>leave chair
I only understood you as far as wanting to leave.

>get off chiar
You can't see any such thing.

>get off chair
You just can't get up, you are way too comfortable! Maybe if you just stayed here in this chair forever you would be better off than whatever else you were going to do. Does it really matter?

"What a lovely soft and dreamy world", you think. Nothing is wrong and everything is right. Right and soft. Sooooo sooooofffft.

>get off chair
You try to heave yourself up, but the soft lusciousness of the chair envelopes you and pulls you back into its comfy folds. Oooooo...so comfy...so sooooooofffffft...

"What a lovely soft and dreamy world", you think. Nothing is wrong and everything is right. Right and soft. Sooooo sooooofffft.

>get of chair
You can't see any such thing.

>get off chair
Whew! You just barely escaped that chair, it's so comfy you could get stuck in it forever!

>enter chair
Oh boy this chair looks really soft and comfy! Ooooh ya you are totally gonna sit on this chair big time.

"Hey Wait!" your subconscious jumps forth remembering the tempting softness - you decide not not to sit on that chair, it's so comfy you might never get up again! It looks seriously comfy though...maybe just for a little tiny sliver of a moment you could get kinda comfy...

>get off chair
But you aren't on the chair at the moment.

* * *

>give bartender coin
She accepts with a smile and slides you a smoothie. It looks friggin delicious.

>i
You're carrying a smoothie. You're wearing a wig.

>look at smoothie
This thing is like taking a bath in frozen unicorn snot. Amazing.

* * *

>give bartender coin
She accepts with a smile and slides you a smoothie. It looks friggin delicious.

>inventory
You're carrying a smoothie. You're wearing a wig.

* * *

>give bartender coin
She accepts with a smile and slides you a smoothie. It looks friggin delicious.

>look at smoothie
You can't see any such thing.

>look at blah
This thing is like taking a bath in frozen unicorn snot. Amazing.

* * *

>go east
(first opening the airlock)

Veranda Walkway
Outside the Space Lounge you look out into the larger Raditree Building to see the pool with under a high ceiling. Consuite lies beyond the pool in the main courtyard. Boffers beat each other up in the fenced in section of the courtyard. A floating dolphin surveillance pod floats by making you twitch instintively to make your shiny wig come between the camera and your face.

You can see an airlock, a black rod, and a floating dolphin (closed) here.

(From here, you can move to north, northeast, northwest, southeast, west, up, and down.)

>n
Floor Changer
Elevators, escalators, and stairwell.

(From here, you can move to north, northeast, south, east, west, and down.)

>n
Elevator
You are in an elevator!

(From here, you can move to south.)

>s
Floor Changer
Elevators, escalators, and stairwell.

(From here, you can move to north, northeast, south, east, west, and down.)

>d
Lower Floor Changer
Lower elevators, escalators and stairwell lower level

(From here, you can move to north, northeast, south, and up.)

>n
Elevator
You are in an elevator!

(From here, you can move to south.)

* * *

>go north
You can't go that way.

>go south
(first opening the airlock)
It seems to be locked.

>open box
You open the glittery box, revealing a security readout, a bowl and a crazy looking gun.

>take gun
You have no idea what this gun does. You've never seen anything like it! You're pretty stoked to get this gun.

Taken.

* * *

>take key
Taken.

>open airlock
It seems to be locked.

>open airlock with key
You unlock the airlock.

>go airlock
(first opening the airlock)

Overlooking Hallway
Outside the Space Lounge you look out into the larger Raditree Building to see the pool with under a high ceiling. Consuite lies beyond the pool in the main courtyard. Boffers beat each other up in the fenced in section of the courtyard. A floating dolphin surveillance pod floats by making you twitch instintively to make your shiny wig come between the camera and your face.

You can see an airlock, a black rod and a floating dolphin (empty) here.

>take rod
Taken.

>xyzzy
you feel a whooshy sound enter your eyeball sockets and then your tummy flips over your groiny-place. WHOOOOOAAAA suddenly you find yourself trasported to the...

Secret Room
You are in the Secret Room. DON'T TELL ANYONE YOU WERE EVER HERE! It's really dark, you can't see much.

Under the influence of the black rod, you pronounce this as Xhi-zee.

>cast xyzzy
you feel a whooshy sound enter your eyeball sockets and then your tummy flips over your groiny-place. WHOOOOOAAAA suddenly you find yourself trasported to the...

Secret Room
You are in the Secret Room. DON'T TELL ANYONE YOU WERE EVER HERE! It's really dark, you can't see much.

Under the influence of the black rod, you pronounce this as Xhi-zee.

* * *

>i
You're carrying a coin. You're wearing a wig.

>e
(first opening the airlock)

Veranda Walkway
Outside the Space Lounge you look out into the larger Raditree Building to see the pool with under a high ceiling. Consuite lies beyond the pool in the main courtyard. Boffers beat each other up in the fenced in section of the courtyard. A floating dolphin surveillance pod floats by making you twitch instintively to make your shiny wig come between the camera and your face.

You can see an airlock, a black rod, and a floating dolphin (closed) here.

You can go north, northeast, northwest, southeast, west through the airlock to the Space Lounge, up, and down from here.

(From here, you can move to north, northeast, northwest, southeast, west, up, and down.)

>n
Floor Changer
Elevators, escalators, and stairwell.

You can go northeast, northwest, south to the Veranda Walkway, east, west, and down from here.

(From here, you can move to northeast, northwest, south, east, west, and down.)

* * *

>wear ninja
You put on the ninja costume.

>i
You're empty-handed. You're wearing a ninja costume and a wig.

* * *

>i
You're carrying a coin. You're wearing a wig.

>give bartender coin
She accepts with a smile.

>ask bartender about xx
"Sorry, I don't know much about that," The bartender comments throatily.

>xx
That's not a verb I recognize.

>bartender xx
That's not a verb I recognize.

>xx bartender
That's not a verb I recognize.

* * *

>inventory
You're carrying a coin. You're wearing a wig.

>give bartender coin
She accepts with a smile.

* * *

>look
Space Lounge
You are in the Space Lounge, rumored to be the center of The Resistance. "Why did I come here?" you briefly wonder before looking around.

You can see an airlock, a bar (on which are a glittery box (closed) and a Glowing Sphere), a chair, a bench, a bartender, a black ninja outfit, AFrame, and a Security bot here.

You can go east through the airlock (closed) from here.

(From here, you can move to east.)

>ask aframe about xx
When you mention xx, Aframe's eyes light up. He smiles and looks around the room for a second before stepping closer to you. "How do you know aobut xx?", he says - well it doesn't matter now - just remember yy when you get to the zz okay? DON'T FORGET ABOUT THE YY! Then he looks around again and slowly fades from view, like all the color faded to grey, then all the outlines of his features just slowly alpha-fade to zero.

>look self
As good-looking as ever.

>i
You're carrying a coin. You're wearing a wig.

>give coin to aframe
You can't see any such thing.

>give coin to bartender
She accepts with a smile.

>look bartender
The bartender is standing there looking you over.

>look bartender
The bartender is dancing.

>look
Space Lounge
You are in the Space Lounge, rumored to be the center of The Resistance. "Why did I come here?" you briefly wonder before looking around.

You can see an airlock, a bar (on which are a glittery box (closed) and a Glowing Sphere), a chair, a bench, a bartender, a black ninja outfit, and a Security bot here.

You can go east through the airlock (closed) from here.

(From here, you can move to east.)

>look
Space Lounge
You are in the Space Lounge, rumored to be the center of The Resistance. "Why did I come here?" you briefly wonder before looking around.

You can see an airlock, a bar (on which are a glittery box (closed) and a Glowing Sphere), a chair, a bench, a bartender, a black ninja outfit, and a Security bot here.

You can go east through the airlock (closed) from here.

(From here, you can move to east.)

>look bartender
The bartender is standing there looking you over.

* * *

>look bartender
The bartender is dancing.

>look bartender
The bartender is standing there looking you over.

>look bartender
The bartender is making a glow in the dark smoothie.

>look bartender
The bartender is dancing.

* * *

>look bartender
The bartender is standing there looking you over.

>look bartender
The bartender is serving some smoothies.

>look bartender
The bartender is cleaning the blender.

>look bartender
The bartender is dancing.

>look bartender
The bartender is serving some smoothies.

* * *

>look bartender
The bartender is cleaning the blender.

>look bartender
The bartender is talking with a friend.

>look bartender
The bartender is cleaning the blender.

>look bartender
The bartender is making a neon yellow smoothie.

>i
You're empty-handed. You're wearing a wig.

* * *

>look
Space Lounge
You are in the Space Lounge, rumored to be the center of The Resistance. "Why did I come here?" you briefly wonder before looking around.

You can see an airlock, a bar (on which are a glittery box (closed) and a Glowing Sphere), a chair, a bench, a bartender, a black ninja outfit, AFrame, and a Security bot here.

You can go east through the airlock (closed) from here.

(From here, you can move to east.)

>e
(first opening the airlock)

Veranda Walkway
Outside the Space Lounge you look out into the larger Raditree Building to see the pool with under a high ceiling. Consuite lies beyond the pool in the main courtyard. Boffers beat each other up in the fenced in section of the courtyard. A floating dolphin surveillance pod floats by making you twitch instintively to make your shiny wig come between the camera and your face.

You can see an airlock, a black rod, and a floating dolphin (closed) here.

You can go north, northeast, northwest, southeast, west through the airlock to the Space Lounge, up, and down from here.

(From here, you can move to north, northeast, northwest, southeast, west, up, and down.)

* * *

>w
Convergence Central
Convergence Central

You can go northeast, south, southwest, and east to the Floor Changer from here.

(From here, you can move to northeast, south, southwest, and east.)

>map
That's not a verb I recognize.

>look
Convergence Central
Convergence Central

You can go northeast, south, southwest, and east to the Floor Changer from here.

(From here, you can move to northeast, south, southwest, and east.)

>sw
Dealer's Room
Dealer's Room

You can see a ninja costume here.

You can go northeast to Convergence Central from here.

(From here, you can move to northeast.)

* * *

>take ninja costume
Taken.

>look self
As good-looking as ever.

>hit points
You can't see any such thing.

* * *

>look
Space Lounge
You are in the Space Lounge, rumored to be the center of The Resistance. "Why did I come here?" you briefly wonder before looking around.

You can see an airlock, a bar (on which are a glittery box (closed) and a Glowing Sphere), a chair, a bench, a bartender, a black ninja outfit, AFrame, and a Security bot here.

You can go east through the airlock (closed) from here.

(From here, you can move to east.)

>look Mario Hat
You can't see any such thing.

>look
Space Lounge
You are in the Space Lounge, rumored to be the center of The Resistance. "Why did I come here?" you briefly wonder before looking around.

You can see an airlock, a bar (on which are a glittery box (closed) and a Glowing Sphere), a chair, a bench, and a bartender here.

You can go east through the airlock (closed) from here.

(From here, you can move to east.)

>e
(first opening the airlock)

Veranda Walkway
Outside the Space Lounge you look out into the larger Raditree Building to see the pool with under a high ceiling. Consuite lies beyond the pool in the main courtyard. Boffers beat each other up in the fenced in section of the courtyard. A floating dolphin surveillance pod floats by making you twitch instintively to make your shiny wig come between the camera and your face.

You can see an airlock, a black rod, and a floating dolphin (closed) here.

You can go north, northeast, northwest, southeast, west through the airlock to the Space Lounge, up, and down from here.

(From here, you can move to north, northeast, northwest, southeast, west, up, and down.)

* * *

>look
Space Lounge
You are in the Space Lounge, rumored to be the center of The Resistance. "Why did I come here?" you briefly wonder before looking around.

You can see an airlock, a bar (on which are a glittery box (closed) and a Glowing Sphere), a chair, a bench, a bartender, a black ninja outfit, AFrame, and a Security bot here.

You can go east through the airlock (closed) from here.

(From here, you can move to east.)

>sit chair
I didn't understand that sentence.

>sit on chair
Oh boy this chair looks really soft and comfy! Ooooh ya you are totally gonna sit on this chair big time.

You sit down and are so comfortable - you could really get used to being in this chair. Really! Wowsers...it's just the comfiest thing you probably ever plopped yer can on...it's like you're almost part of this thing...like your skin is melding with it and your insides are turning to some sort of tiny little beans...or a kind of foam batting material...

"What a lovely soft and dreamy world", you think. Nothing is wrong and everything is right. Right and soft. Sooooo sooooofffft.

>look
Space Lounge (on the chair)
You are in the Space Lounge, rumored to be the center of The Resistance. "Why did I come here?" you briefly wonder before looking around.

You can see an airlock, a bar (on which are a glittery box (closed) and a Glowing Sphere), a bench, a bartender, a black ninja outfit, AFrame, and a Security bot here.

You can go east through the airlock (closed) from here.

(From here, you can move to east.)

"What a lovely soft and dreamy world", you think. Nothing is wrong and everything is right. Right and soft. Sooooo sooooofffft.

>e
(first opening the airlock)
(first unlocking the airlock)
You'd rather be asleep. Whatever other thing you would do besides being in this chair is a bad idea and not really that good of an option compared to being in this insanely comfy chair.

"What a lovely soft and dreamy world", you think. Nothing is wrong and everything is right. Right and soft. Sooooo sooooofffft.

>get up from chair
You just can't get up, you are way too comfortable! Maybe if you just stayed here in this chair forever you would be better off than whatever else you were going to do. Does it really matter?

"What a lovely soft and dreamy world", you think. Nothing is wrong and everything is right. Right and soft. Sooooo sooooofffft.

>get up from chair
You try to heave yourself up, but the soft lusciousness of the chair envelopes you and pulls you back into its comfy folds. Oooooo...so comfy...so sooooooofffffft...

"What a lovely soft and dreamy world", you think. Nothing is wrong and everything is right. Right and soft. Sooooo sooooofffft.

>get up from chair
"What a lovely soft and dreamy world", you think. Nothing is wrong and everything is right. Right and soft. Sooooo sooooofffft.

>get up from chair
Whew! You just barely escaped that chair, it's so comfy you could get stuck in it forever!

>get up from chair
But you aren't on the chair at the moment.

>look chair
Watch out for that chair, it's so comfy you could get stuck in it forever! Like LITERALLY foreverandever.

>sit on chair
Oh boy this chair looks really soft and comfy! Ooooh ya you are totally gonna sit on this chair big time.

"Hey Wait!" your subconscious jumps forth remembering the tempting softness - you decide not not to sit on that chair, it's so comfy you might never get up again! It looks seriously comfy though...maybe just for a little tiny sliver of a moment you could get kinda comfy...

* * *

>look AFrame
You can't see any such thing.

>take costume
Taken.

>look costume
The black ninja costume is kind of unremarkable, not really exciting like some cool crazy gun would be or something.

The black ninja costume's pocket contains a throwing star and a smoke bomb.

>wear costume
You put on the black ninja costume.

>look self
As good-looking as ever.

* * *

>look aframe
Aframe is looking pretty sharp there wearing a pin-striped suit with his usual aplomb.

>aframe, remove suit
He says "sure, anything for a laugh!"
AFrame takes off the pin-striped suit.

>look aframe
Aframe is looking pretty sharp there wearing a pink thong with his usual aplomb.

>aframe, remove pink thong
He says "sure, anything for a laugh!"
AFrame takes off the pink thong.

>look aframe
Aframe is looking pretty sharp there wearing nothing with his usual aplomb.

>aframe, put on pink thong
He says "sure, anything for a laugh!"
AFrame puts on the pink thong.

>aframe, put on suit
He says "sure, anything for a laugh!"
AFrame puts on the pin-striped suit.

>take ninja outfit
Taken.

>give aframe ninja outfit
AFrame doesn't seem interested.

>aframe, take ninja outfit
He says "sure, anything for a laugh!"
AFrame is unable to do that.

>e
(first opening the airlock)
(first unlocking the airlock)
You lack a key that fits the airlock.

>look
Space Lounge
You are in the Space Lounge, rumored to be the center of The Resistance. "Why did I come here?" you briefly wonder before looking around.

You can see an airlock, a bar (on which are a glittery box (closed) and a Glowing Sphere), a chair, a bench, a bartender, AFrame, and a Security bot here.

You can go east through the airlock (closed) from here.

(From here, you can move to east.)

>tell aframe
I didn't understand that sentence.

>tell aframe to put on ninja suit
I didn't understand that sentence.

>i
You're carrying a black ninja outfit and a coin. You're wearing a wig.

>open box
You open the glittery box, revealing a security readout, a bowl, and a crazy looking gun.

* * *

>shoot aframe
(with the crazy looking gun)
This weird ray comes out of your gun but it's like it's moving in slow-motion...as the beam wiggles toward Aframe super duper slow he steps out of the way of it. The wiggling intensifies and disappears. Aframe is looking at you with this annoyed look. Like he doesn't totally trust you anymore because you just tried to twinkle him out of existence.

>aframe, remove suit
He says "uhm I am not going to help you out because in case you forgot you tried to kill me. I don't even know why"

* * *

>take gun
You have no idea what this gun does. You've never seen anything like it! You're pretty stoked to get this gun.

Taken.

>shoot aframe with gun
This weird ray comes out of your gun but it's like it's moving in slow-motion...as the beam wiggles toward Aframe super duper slow and he steps out of the way of it, the wiggling intensifies and disappears. Aframe is looking at you with this annoyed look. Like he doesn't totally trust you anymore because you just tried to twinkle him out of existence.

>aframe, remove suit
He says "uhm I am not going to help you out because in case you forgot you tried to kill me. I don't even know why

* * *

>look aframe
Aframe is looking pretty sharp there wearing a pin-striped suit with his usual aplomb.

>ask aframe to take off his suit
I didn't understand that sentence.

>ask aframe to remove suit
I didn't understand that sentence.

>aframe, remove suit
AFrame takes off the pin-striped suit.

>look aframe
Aframe leans on a polystyrene pillar, wearing a pink thong with his usual aplomb.

>ask aframe about xx
When you mention xx, Aframe's eyes light up. He smiles and looks around the room for a second before stepping closer to you. "How do you know aobut xx?", he says - well it doesn't matter now - just remember yy when you get to the zz okay? DON'T FORGET ABOUT THE YY! Then he looks around again and slowly fades from view, like all the color faded to grey, then all the outlines of his features just slowly alpha-faded to zero.

>look
Space Lounge
You are in the Space Lounge, rumored to be the center of The Resistance. "Why did I come here?" you briefly wonder before looking around.

You can see an airlock, a bar (on which are a glittery box (closed) and a Glowing Sphere), a chair, a bench, a bartender, a black ninja outfit, and a Security bot here.

You can go east through the airlock (closed) from here.

(From here, you can move to east.)

>look aframe
You can't see any such thing.

* * *

>take rod
Taken.

>xyyz
That's not a verb I recognize.

>w
Space Lounge
You are in the Space Lounge, rumored to be the center of The Resistance. "Why did I come here?" you briefly wonder before looking around.

You can see an airlock, a bar (on which are a glittery box (closed) and a Glowing Sphere), a chair, a bench, a bartender, a black ninja outfit, and a Security bot here.

You can go east through the airlock to the Veranda Walkway from here.

(From here, you can move to east.)

>look box
Time slows down, you feel as if you gazing into the cosmos itself. Your eyeballs can hardly stay on it, it's like your gaze just keeps sliding off.

>open box
You open the glittery box, revealing a security readout, a bowl, and a crazy looking gun.

>look bowl
The bowl is kind of unremarkable, not really exciting like some cool crazy gun would be or something.

In the bowl is a note.

* * *

>look note
Cast the secret spell xyzzy

>xyzzy
you feel a whooshy sound enter your eyeball sockets and then your tummy flips over your groiny-place. WHOOOOOAAAA suddenly you find yourself trasported to the...

you feel a whooshy sound enter your eyeball sockets and then your tummy flips over your groiny-place. WHOOOOOAAAA suddenly you find yourself trasported to the...

Secret Room
You are in the Secret Room. DON'T TELL ANYONE YOU WERE EVER HERE! It's really dark, you can't see much.

You can see AFrame, a dolphin code, and a book here.

You can see no obvious exits.

(There are no routes out of this room.)

Under the influence of the black rod, you pronounced "xyzzy" as Xhi-zee. You understand now that the purpose of the black rod is to bring people here, to the Secret Room.

>talk aframe
That's not a verb I recognize.

* * *

>look airlock
The airlock has a small window through which you can see a vast open space - is that a pool? Sweet!. There's some sort of security readout thing on the door and it looks like the door only opens with a security key.

>look readout
You can't see any such thing.

>look at readout
You can't see any such thing.

>look airlock readout
I only understood you as far as wanting to look the airlock.

>e
(first opening the airlock)

Veranda Walkway
Outside the Space Lounge you look out into the larger Raditree Building to see the pool with under a high ceiling. Consuite lies beyond the pool in the main courtyard. Boffers beat each other up in the fenced in section of the courtyard. A floating dolphin surveillance pod floats by making you twitch instintively to make your shiny wig come between the camera and your face.

You can see an airlock, a black rod, and a floating dolphin (closed) here.

You can go north, northeast, northwest, southeast, west through the airlock to the Space Lounge, up, and down from here.

(From here, you can move to north, northeast, northwest, southeast, west, up, and down.)

>look ceiling
The ceiling with lights rises over the whole crazy convention.

* * *

>look bartender
The bartender is serving some smoothies.

>look bartender
The bartender is dancing.

* * *

>look bartender
The bartender is standing there looking you over.

>look bartender
The bartender is cleaning the blender.

* * *

>look bartender
The bartender is talking with a friend.

>look bartender
The bartender is making a glow in the dark smoothie.

* * *

>look bartender
The bartender is dancing.

>look bartender
The bartender is cleaning the blender.

>look bartender
The bartender is standing there looking you over.

>look bartender
The bartender is making a neon yellow smoothie.

>look bartender
The bartender is dancing.

>talk bartender
That's not a verb I recognize.

>talk with bartender
That's not a verb I recognize.

>bartender, hello
There is no reply.

>ask bartender for smoothie
You can't see any such thing.

* * *

>look box
Time slows down, you feel as if you gazing into the cosmos itself. Your eyeballs can hardly stay on it, it's like your gaze just keeps sliding off.

>open box
You open the glittery box, revealing a bowl and a crazy looking gun.

>look bowl
The bowl is kind of unremarkable, not really exciting like some cool crazy gun would be or something.

In the bowl is a note.

>look gun
That gun is so crazy looking! It's kind of like totally blowing your mind.

>look note
Cast the secret spell xyzzy

>cast spell
I didn't understand that sentence.

>xyzzy
You are unable to articulate the second "z" separately from the first, and the spell fails in a disdainful puff. If only you had the black rod.

>get rod
Taken.

>xyzzy
you feel a whooshy sound enter your eyeball sockets and then your tummy flips over your groiny-place. WHOOOOOAAAA suddenly you find yourself trasported to...

Overlooking Hallway
Outside the Space Lounge you look out into the larger Raditree Building to see the pool with under a high ceiling. Consuite lies beyond the pool in the main courtyard. Boffers beat each other up in the fenced in section of the courtyard. A floating dolphin surveillance pod floats by making you twitch instintively to make your shiny wig come between the camera and your face.

You can see a floating dolphin (empty) here.

Under the influence of the black rod, you pronounce this as Xhi-zee.

>look
Overlooking Hallway
Outside the Space Lounge you look out into the larger Raditree Building to see the pool with under a high ceiling. Consuite lies beyond the pool in the main courtyard. Boffers beat each other up in the fenced in section of the courtyard. A floating dolphin surveillance pod floats by making you twitch instintively to make your shiny wig come between the camera and your face.

You can see a floating dolphin (empty) here.

>look dolphin
Oh crap - the floating dolphin's survellance cam is honing in on you! You better get out of here, somewhere where the floating dolphin camera can't see you.

>go north
You can't go that way.

>go east
You can't go that way.

>got west
That's not a verb I recognise.

>go west
You can't go that way.

>get dolphin
That's fixed in place.

>go south
Space Lounge
You are in the Space Lounge, rumored to be the center of The Resistance. "Why did I come here?" you briefly wonder before looking around. You can go north to exit the Space Lounge.

You can see a bar (on which is a glittery box (in which are a bowl (in which is a note) and a crazy looking gun)), a soft chair, a skate ramp technology chair, Many soft chairs and a bartender here.

>look chair
Which do you mean, the soft chair or the skate ramp technology chair?

>look skate ramp technology chair
The skate ramp technology chair is kind of unremarkable, not really exciting like some cool crazy gun would be or something.

>look soft chair
The soft chair is kind of unremarkable, not really exciting like some cool crazy gun would be or something.

>sit chair
I didn't understand that sentence.

>get gun
You have no idea what this gun does. You've never seen anything like it! You're pretty stoked to get this gun.

Taken.

>go north
Overlooking Hallway
Outside the Space Lounge you look out into the larger Raditree Building to see the pool with under a high ceiling. Consuite lies beyond the pool in the main courtyard. Boffers beat each other up in the fenced in section of the courtyard. A floating dolphin surveillance pod floats by making you twitch instintively to make your shiny wig come between the camera and your face.

You can see a floating dolphin (empty) here.

>shoot gun
(at the black rod)
ZAP! The black rod twinkles out of existence!

>go south
Space Lounge
You are in the Space Lounge, rumored to be the center of The Resistance. "Why did I come here?" you briefly wonder before looking around. You can go north to exit the Space Lounge.

You can see a bar (on which is a glittery box (in which is a bowl (in which is a note))), a soft chair, a skate ramp technology chair, Many soft chairs and a bartender here.

>talk bartender
That's not a verb I recognise.

>speak bartender
(to the bartender)
There is no reply.

>go north
Overlooking Hallway
Outside the Space Lounge you look out into the larger Raditree Building to see the pool with under a high ceiling. Consuite lies beyond the pool in the main courtyard. Boffers beat each other up in the fenced in section of the courtyard. A floating dolphin surveillance pod floats by making you twitch instintively to make your shiny wig come between the camera and your face.

You can see a floating dolphin (empty) here.

>look dolphin
Oh crap - the floating dolphin's survellance cam is honing in on you! You better get out of here, somewhere where the floating dolphin camera can't see you.

>enter dolphin
You get into the floating dolphin.

>go south
Space Lounge (in the floating dolphin)
You are in the Space Lounge, rumored to be the center of The Resistance. "Why did I come here?" you briefly wonder before looking around. You can go north to exit the Space Lounge.

You can see a bar (on which is a glittery box (in which is a bowl (in which is a note))), a soft chair, a skate ramp technology chair, Many soft chairs and a bartender here.

>shoot bartender
(with the crazy looking gun)
ZAP! The bartender twinkles out of existence!

>shoot dolphin
(with the crazy looking gun)
ZAP! The floating dolphin twinkles out of existence! 

*** Run-time problem P61: Attempt to move the player off-stage.

>look
Space Lounge (in the floating dolphin)
You are in the Space Lounge, rumored to be the center of The Resistance. "Why did I come here?" you briefly wonder before looking around. You can go north to exit the Space Lounge.

You can see a bar (on which is a glittery box (in which is a bowl (in which is a note))), a soft chair, a skate ramp technology chair and Many soft chairs here.

>shoot me
(with the crazy looking gun)
That would be disastrous!

>shoot gun
What do you want to shoot the crazy looking gun at?

>shoot space lounge
You can't see any such thing.

>shoot gun with gun
Nice trick if you can do it!

* * *

>look box
Time slows down, you feel as if you gazing into the cosmos itself. Your eyeballs can hardly stay on it, it's like your gaze just keeps sliding off.

>take box
OOOHhhhhhh! You get a funny tingle when you try to pick the box up, the sides are so slippery it almost feels COMPLETELY FRICTIONLESS. You can't seem to grab it all, it's really weird.

>look sphere
OOOOoooo glowy-sphere thingie! Its purple soft glow makes you feel safe and secure. It looks like there's some sort of helix-key as a component to the glowy-ness but it's unclear how you would remove it.

>take sphere
That's fixed in place.

>break sphere
Violence isn't the answer to this one.

>go east
(first opening the airlock)

Veranda Walkway
Outside the Space Lounge you look out into the larger Raditree Building to see the pool with under a high ceiling. Consuite lies beyond the pool in the main courtyard. Boffers beat each other up in the fenced in section of the courtyard. A floating dolphin surveillance pod floats by making you twitch instintively to make your shiny wig come between the camera and your face.

You can see an airlock, a black rod, and a floating dolphin (closed) here.

(From here, you can move to north, northeast, northwest, southeast, west, up, and down.)

>go north
Floor Changer
Elevators, escalators, and stairwell.

(From here, you can move to northeast, northwest, south, east, west, and down.)

>go north west
I only understood you as far as wanting to go north.

>go northwest
Upper Tower Connector
The Upper Tower Connector - connection between the short and tall towers.

(From here, you can move to southeast and southwest.)

>go southwest
Convergence Central
Convergence Central

(From here, you can move to northeast, south, southwest, and east.)

>go south
Mainstage
Mainstage

(From here, you can move to north.)

>go north
Convergence Central
Convergence Central

(From here, you can move to northeast, south, southwest, and east.)

>go east
Floor Changer
Elevators, escalators, and stairwell.

(From here, you can move to northeast, northwest, south, east, west, and down.)

>go w
Convergence Central
Convergence Central

(From here, you can move to northeast, south, southwest, and east.)

>go sw
Dealer's Room
Dealer's Room

(From here, you can move to northeast.)

>ne
Convergence Central
Convergence Central

(From here, you can move to northeast, south, southwest, and east.)

>e
Floor Changer
Elevators, escalators, and stairwell.

(From here, you can move to northeast, northwest, south, east, west, and down.)

>down
Lower Floor Changer
Lower elevators, escalators and stairwell lower level

(From here, you can move to north, northeast, northwest, south, southwest, west, and up.)

>n
Elevator Line
You are waiting for an elevator!

(From here, you can move to south.)

>s
Lower Floor Changer
Lower elevators, escalators and stairwell lower level

(From here, you can move to north, northeast, northwest, south, southwest, west, and up.)

>ne
Stairwell Floor 1
Stairwell Floor 1

(From here, you can move to southwest and up.)

>sw
Lower Floor Changer
Lower elevators, escalators and stairwell lower level

(From here, you can move to north, northeast, northwest, south, southwest, west, and up.)

>w
Front Desk
The Front Desk

(From here, you can move to east.)

>e
Lower Floor Changer
Lower elevators, escalators and stairwell lower level

(From here, you can move to north, northeast, northwest, south, southwest, west, and up.)

>up
Floor Changer
Elevators, escalators, and stairwell.

(From here, you can move to northeast, northwest, south, east, west, and down.)

>up
You can't go that way.

>e
Upper Northside Hallway
A hallway filled with freaks and nerds.

(From here, you can move to south, southeast, southwest, and west.)

>s
Room 205
Room 205

(From here, you can move to north.)

>n
Upper Northside Hallway
A hallway filled with freaks and nerds.

(From here, you can move to south, southeast, southwest, and west.)

>se
Consuite
(From here, you can move to northwest, southwest, and down.)

>nw
Upper Northside Hallway
A hallway filled with freaks and nerds.

(From here, you can move to south, southeast, southwest, and west.)

>se
Consuite
(From here, you can move to northwest, southwest, and down.)

* * *

>look chair
The soft chair looks seriously comfortable, it's all soft and squishy looking. "SPYUMMY", your butt thinks.

>sit chair
I didn't understand that sentence.

>sit on chair
Oh boy this chair looks really soft and comfy! Ooooh ya you are totally gonna sit on this chair big time.

You sit down and are so comfortable - you could really get used to being in this chair.

"What a lovely soft and dreamy world", you think. Nothing is wrong and everything is right. Right and soft. Sooooo sooooofffft.

>get up
You'd rather be asleep.

"What a lovely soft and dreamy world", you think. Nothing is wrong and everything is right. Right and soft. Sooooo sooooofffft.

>get up
You'd rather be asleep.

"What a lovely soft and dreamy world", you think. Nothing is wrong and everything is right. Right and soft. Sooooo sooooofffft.

>get out of chair
I only understood you as far as wanting to get outside.

>get up
You'd rather be asleep.

"What a lovely soft and dreamy world", you think. Nothing is wrong and everything is right. Right and soft. Sooooo sooooofffft.

>wake up
You'd rather be asleep.

"What a lovely soft and dreamy world", you think. Nothing is wrong and everything is right. Right and soft. Sooooo sooooofffft.

>get out of chair
I only understood you as far as wanting to get outside.

>stand
You'd rather be asleep.

"What a lovely soft and dreamy world", you think. Nothing is wrong and everything is right. Right and soft. Sooooo sooooofffft.

>get up from chair
You just can't get up, you are way too comfortable!

"What a lovely soft and dreamy world", you think. Nothing is wrong and everything is right. Right and soft. Sooooo sooooofffft.

>get up from chair
You try to heave yourself up, but the soft lusciousness of the chair envelopes you and pulls you back into its comfy folds.

"What a lovely soft and dreamy world", you think. Nothing is wrong and everything is right. Right and soft. Sooooo sooooofffft.

>get up from chair
"What a lovely soft and dreamy world", you think. Nothing is wrong and everything is right. Right and soft. Sooooo sooooofffft.

* * *

>get up from chair
Whew! You just barely escaped that chair, it's so comfy you could get stuck in it forever!

>sit bench
I didn't understand that sentence.

>sit on bench
You get onto the bench.

>look
Space Lounge (on the bench)
You are in the Space Lounge, rumored to be the center of The Resistance. "Why did I come here?" you briefly wonder before looking around.

You can see an airlock, a bar (on which are a glittery box (closed) and a Glowing Sphere), a chair, and a bartender here.

You can go east through the airlock (closed) from here.

(From here, you can move to east.)

>open glittery box
You open the glittery box, revealing a security readout, a bowl, and a crazy looking gun.

>look bartender
You see a female bartender with neon hair and glowing robes serving drinks. The bartender is currently helping some other people but if you wait you can probably get a chance to talk to her.

* * *

>look ninja
This is a ninja outfit, it's black and has a hood that covers your face. It has pockets on it to store cool ninja gear. It has these sweet built in booties that muffle your footsteps as if you were a total ninja, which you totally are if you are wearing this outfit. You could totally sneak into a place without being detected if it was dark and you were wearing this thing. You'd be so ninja.

The pocket contains nothing.

>look self
As good-looking as ever.

>take ninja
Taken.

>wear ninja
You are a ninja! It feels like you could blend into the shadows, or maybe you ARE the shadows, this ninja outfit makes you feel super ninja-like

>i
You're empty-handed. You're wearing a black ninja outfit and a wig.

>look
Space Lounge
You are in the Space Lounge, rumored to be the center of The Resistance. "Why did I come here?" you briefly wonder before looking around.

You can see an airlock, a bar (on which are a glittery box (closed) and a Glowing Sphere), a chair, a bench, and a bartender here.

You can go east through the airlock (closed) from here.

(From here, you can move to east.)

>look bartender
You see a female bartender with neon hair and glowing robes serving drinks. The bartender is currently helping some other people but if you wait you can probably get a chance to talk to her.

* * *

>move east
You must name something more substantial.

>move to east
You can't see any such thing.

>east
(first opening the airlock)
(first unlocking the airlock)
You lack a key that fits the airlock.

>open airlock
(first unlocking the airlock)
You lack a key that fits the airlock.

>unlock airlock
You lack a key that fits the airlock.

>glittery box
That's not a verb I recognize.

>open glittery box
You open the glittery box, revealing a security readout, a bowl, and a crazy looking gun.

>take gun
You have no idea what this gun does. You've never seen anything like it! You're pretty stoked to get this gun.

Taken.

>take bowl
Taken.

>take security readout
Taken.

>shoot airlock
(with the crazy looking gun)
The crazy gun's ray just bounces off the airlock, it doesn't seem to be able to affect it.

>shoot bartender
(with the crazy looking gun)
The weird ray somehow seems to bend around the bartender and disperses into a cloud of neon-swirled rainbow shards. She looks at you with a strange smirky side-eye. She must be wearing some kind of personal ray-deflector device. "splick", you admire-think.

>shoot bench
(with the crazy looking gun)
ZAP! The bench twinkles out of existence!

>shoot chair
(with the crazy looking gun)
ZAP! The chair twinkles out of existence!

>shoot glowing sphere
(with the crazy looking gun)
ZAP! The Glowing Sphere twinkles out of existence! The security key clatters to the ground!

>take security key
Taken.

>take black ninja outfit
Taken.

>shoot bar
(with the crazy looking gun)
ZAP! The bar twinkles out of existence!

>shoot aframe
(with the crazy looking gun)
This weird ray comes out of your gun but it's like it's moving in slow-motion...as the beam wiggles toward Aframe super duper slow he steps out of the way of it. The wiggling intensifies and disappears. Aframe is looking at you with this annoyed look. Like he doesn't totally trust you anymore because you just tried to twinkle him out of existence.

>shoot security
Which do you mean, the Security bot, the security key, or the security readout?

>shoot security boy
Which do you mean, the Security bot, the security key, or the security readout?

>shoot security bot
(with the crazy looking gun)
ZAP! The Security bot twinkles out of existence!

>unlock airlock
(with the security key)
You unlock the airlock.

>east
(first opening the airlock)

Veranda Walkway
Outside the Space Lounge you look out into the larger Raditree Building to see the pool with under a high ceiling. Consuite lies beyond the pool in the main courtyard. Boffers beat each other up in the fenced in section of the courtyard. A floating dolphin surveillance pod floats by making you twitch instintively to make your shiny wig come between the camera and your face.

You can see an airlock, a black rod, and a floating dolphin (closed) here.

You can go north, northeast, northwest, southeast, west through the airlock to the Space Lounge, up, and down from here.

(From here, you can move to north, northeast, northwest, southeast, west, up, and down.)

>take black rod
Taken.

>take floating dolphin
That's fixed in place.

>open floating dolphin
(first unlocking the floating dolphin)
You lack a key that fits the floating dolphin.

>west
Space Lounge
You are in the Space Lounge, rumored to be the center of The Resistance. "Why did I come here?" you briefly wonder before looking around.

You can see an airlock, a bartender, and AFrame here.

You can go east through the airlock to the Veranda Walkway from here.

(From here, you can move to east.)

>look aframe
Aframe is looking pretty sharp there wearing a pin-striped suit with his usual aplomb.

>ask aframe
What do you want to ask AFrame for?

>ask aframe suit
I didn't understand that sentence.

>ask aframe, suit
You can't use multiple objects with that verb.

>ask aframe what is your suit
I didn't understand that sentence.

>aframe, remove suit
He says "uhm I am not going to help you out because in case you forgot you tried to kill me. I don't even know why"

>unshoot aframe
That's not a verb I recognize.

>apologize aframe
That's not a verb I recognize.

>give black ninja suit to aframe
You can only do that to something animate.

>give aframe security key
AFrame doesn't seem interested.

>give aframe black rod
AFrame doesn't seem interested.

>ask aframe xx
I didn't understand that sentence.

>ask aframe about xx
When you mention xx, Aframe's eyes light up. He smiles and looks around the room for a second before stepping closer to you. "How do you know aobut xx?", he says - well it doesn't matter now - just remember yy when you get to the zz okay? DON'T FORGET ABOUT THE YY! Then he looks around again and slowly fades from view, like all the color faded to grey, then all the outlines of his features just slowly alpha-fade to zero.

>say cool
(to the bartender)
"Hm, you've got me there," The bartender comments.

>say beer
(to the bartender)
"Sorry, I don't know much about that," The bartender drawls huskily.

>ask bartender for a beer
You can't see any such thing.

>say whisky
(to the bartender)
"I'm afraid you've got me there," The bartender comments silkily.

>say noodles
(to the bartender)
"Hm, I don't know much about that," The bartender replies.

>say xx
(to the bartender)
"I'm afraid you've got me there," The bartender comments huskily.

>say yy
(to the bartender)
"Hm, I haven't the faintest," The bartender replies throatily.

>say zz
(to the bartender)
"Sorry, you've got me there," The bartender comments throatily.

>ask zz
You can't see any such thing.

>ask aframe
You can't see any such thing.

>east
Veranda Walkway
Outside the Space Lounge you look out into the larger Raditree Building to see the pool with under a high ceiling. Consuite lies beyond the pool in the main courtyard. Boffers beat each other up in the fenced in section of the courtyard. A floating dolphin surveillance pod floats by making you twitch instintively to make your shiny wig come between the camera and your face.

You can see an airlock and a floating dolphin (closed) here.

You can go north, northeast, northwest, southeast, west through the airlock to the Space Lounge, up, and down from here.

(From here, you can move to north, northeast, northwest, southeast, west, up, and down.)

>use black rod dolphin
That's not a verb I recognize.

>read security
Which do you mean, the security key or the security readout?

>read security readout
The screen is blank.

The security readout is currently switched off.

>turn on security readout
You switch the security readout on.

>read security readout
The screen reads: 

 airlock (Space Lounge/Veranda Walkway): UNLOCKED

>read note
Cast the secret spell xyzzy

* * *

>say woah
(to AFrame)
There is no reply.

>say how did i get here
(to AFrame)
There is no reply.

>say suit
(to AFrame)
There is no reply.

>say xx
(to AFrame)
When you mention xx, Aframe's eyes light up. He smiles and looks around the room for a second before stepping closer to you. "How do you know aobut xx?", he says - well it doesn't matter now - just remember yy when you get to the zz okay? DON'T FORGET ABOUT THE YY! Then he looks around again and slowly fades from view, like all the color faded to grey, then all the outlines of his features just slowly alpha-fade to zero.

>say nodles
(to AFrame)
There is no reply.

>look aframe
Aframe is looking pretty sharp there wearing a pin-striped suit with his usual aplomb.

>aframe, remove suit
He gives this double-wink thing - like winking with one eye twice then the other once then both at the same time then rolls his eyes up then blinks both eyes again. That's the secret code you know cause you're buds.
AFrame takes off the pin-striped suit.

>take suit
That seems to belong to AFrame.

>look aframe
Aframe is looking pretty sharp there wearing a pink thong with his usual aplomb.

>aframe, remove thing
There is no reply.

>aframe, remove pink thong
He gives this double-wink thing - like winking with one eye twice then the other once then both at the same time then rolls his eyes up then blinks both eyes again. That's the secret code you know cause you're buds.
AFrame takes off the pink thong.

>look aframe
Aframe is looking pretty sharp there wearing nothing with his usual aplomb.

>aframe, remove usual aplomb
There is no reply.

>aframe, beer
There is no reply.

>aframe, yy
There is no reply.

>aframe, zz
There is no reply.

>aframe, exit
He gives this double-wink thing - like winking with one eye twice then the other once then both at the same time then rolls his eyes up then blinks both eyes again. That's the secret code you know cause you're buds.
AFrame is unable to do that.

>aframe, dance
There is no reply.

>aframe, end
There is no reply.

>aframe, moonwalk
There is no reply.

>take book
Taken.

>take dolphin code
Taken.

>exit
But you aren't in anything at the moment.

>east
You can't go that way.

>west
You can't go that way.

>south
You can't go that way.

>up
You can't go that way.

>down
You can't go that way.

>sideways
That's not a verb I recognize.

>backflio
That's not a verb I recognize.

>backflip
That's not a verb I recognize.

>booth
That's not a verb I recognize.

>look
Secret Room
You are in the Secret Room. DON'T TELL ANYONE YOU WERE EVER HERE! It's really dark, you can't see much.

You can see AFrame here.

You can see no obvious exits.

(There are no routes out of this room.)

>examine wall
You can't see any such thing.

>look wall
You can't see any such thing.

>say i am in the secret room
(to AFrame)
There is no reply.

>look dolphin code
It is fish shaped, and vibrates - readout screen says "Status optimal".

>look book
"yzxxy" is the title, and the contents just say "Your Future Lies in Space" over and over again.

>yzxxy
Space Lounge
You are in the Space Lounge, rumored to be the center of The Resistance. "Why did I come here?" you briefly wonder before looking around.

You can see an airlock and a bartender here.

You can go east through the airlock to the Veranda Walkway from here.

(From here, you can move to east.)

Under the influence of the black rod, you pronounced "yzxxy" as Wizex-zi. You are glad there is some way out of that Secret Room!

>xxyzz
That's not a verb I recognize.

>xyzzy
you feel a whooshy sound enter your eyeball sockets and then your tummy flips over your groiny-place. WHOOOOOAAAA suddenly you find yourself trasported to the...

you feel a whooshy sound enter your eyeball sockets and then your tummy flips over your groiny-place. WHOOOOOAAAA suddenly you find yourself trasported to the...

Secret Room
You are in the Secret Room. DON'T TELL ANYONE YOU WERE EVER HERE! It's really dark, you can't see much.

You can see AFrame here.

You can see no obvious exits.

(There are no routes out of this room.)

Under the influence of the black rod, you pronounced "xyzzy" as Xhi-zee. You understand now that the purpose of the black rod is to bring people here, to the Secret Room.

>xyzyyx
That's not a verb I recognize.

>xyzzy
you feel a whooshy sound enter your eyeball sockets and then your tummy flips over your groiny-place. WHOOOOOAAAA suddenly you find yourself trasported to the...

you feel a whooshy sound enter your eyeball sockets and then your tummy flips over your groiny-place. WHOOOOOAAAA suddenly you find yourself trasported to the...

Secret Room
You are in the Secret Room. DON'T TELL ANYONE YOU WERE EVER HERE! It's really dark, you can't see much.

You can see AFrame here.

You can see no obvious exits.

(There are no routes out of this room.)

Under the influence of the black rod, you pronounced "xyzzy" as Xhi-zee. You understand now that the purpose of the black rod is to bring people here, to the Secret Room.

>yzxxy
Space Lounge
You are in the Space Lounge, rumored to be the center of The Resistance. "Why did I come here?" you briefly wonder before looking around.

You can see an airlock and a bartender here.

You can go east through the airlock to the Veranda Walkway from here.

(From here, you can move to east.)

Under the influence of the black rod, you pronounced "yzxxy" as Wizex-zi. You are glad there is some way out of that Secret Room!

>xxxxx
That's not a verb I recognize.

>yyyyy
That's not a verb I recognize.

>zzzzz
That's not a verb I recognize.

>go floating courtyard
You can't see any such thing.

>east
Veranda Walkway
Outside the Space Lounge you look out into the larger Raditree Building to see the pool with under a high ceiling. Consuite lies beyond the pool in the main courtyard. Boffers beat each other up in the fenced in section of the courtyard. A floating dolphin surveillance pod floats by making you twitch instintively to make your shiny wig come between the camera and your face.

You can see an airlock and a floating dolphin (closed) here.

You can go north, northeast, northwest, southeast, west through the airlock to the Space Lounge, up, and down from here.

(From here, you can move to north, northeast, northwest, southeast, west, up, and down.)

>up
You don't have wings or pyscho-kinetic levitation abilities or a hoverboard or anything to go up with.

>use dolphin
That's not a verb I recognize.

>ride dolphin
That's not a verb I recognize.

>enter dolphin
(the dolphin code)
That's not something you can enter.

>enter floating dolphin
You have access to the floating dolphin. Wow - you'll be able to go up above the courtyard now and see everything!

You can't get into the closed floating dolphin.

>open floating dolphin
(first unlocking the floating dolphin)
(with the dolphin code)
You open the floating dolphin.

>enter floating dolphin
You have access to the floating dolphin. Wow - you'll be able to go up above the courtyard now and see everything!

Go up!

>up
Floating Courtyard (in the floating dolphin)
The floating dolphin is transparent, but tints everything outside very faintly lavender.

This is amazing - you are up above everything and can see so much up here! There's a pool down below, and a fenced in courtyard with some kind of security gate system surrounding it, and Consuite.

You can go down to the Veranda Walkway from here.

(From here, you can move to down.)

>up
You can't go that way.

>up
You can't go that way.

>up again
I only understood you as far as wanting to (go) up.

>exit dolphin
I only understood you as far as wanting to exit.

>look ninja
This is a ninja outfit, it's black and has a hood that covers your face. It has pockets in it to store cool ninja gear. It has these sweet built in booties that muffle your footsteps as if you were a total ninja, which you totally are if you are wearing this outfit. You could sneak around a place with shadows without being detected if you were wearing this thing. You'd be so ninja.

The pocket contains nothing.

>wear ninja
You are a ninja! It feels like you could blend into the shadows, or maybe you ARE the shadows, this ninja outfit makes you feel super ninja-like

>look self
As good-looking as ever.

>exit floating dolphin
I only understood you as far as wanting to exit.

I beg your pardon?

I beg your pardon?

>burn wig
This dangerous act would achieve little.

>shoot wig
(with the crazy looking gun)
ZAP! The wig twinkles out of existence!

>shoot self
(with the crazy looking gun)
That would be disastrous!

>i dont care
I only understood you as far as wanting to take inventory.

>shoot gun
What do you want to shoot the crazy looking gun at?

>shoot gun gun
What do you want to shoot the crazy looking gun at?

>shoot gun with gun
Nice trick if you can do it!

>shoot gun at mirror towards gun
You can't see any such thing.

>shoot foot
You can't see any such thing.

>shoot floating dolphin
(with the crazy looking gun)
ZAP! The floating dolphin twinkles out of existence! 

*** Run-time problem P61: Attempt to move the player off-stage.

* * *

>open airlock
You open the airlock.

>east
Veranda Walkway
Outside the Space Lounge you look out into the larger Raditree Building to see the pool with under a high ceiling. Consuite lies beyond the pool in the main courtyard. Boffers beat each other up in the fenced in section of the courtyard. A floating dolphin surveillance pod floats by making you twitch instintively to make your shiny wig come between the camera and your face.

You can see an airlock, a black rod, and a floating dolphin (closed) here.

You can go north, northeast, northwest, southeast, west through the airlock to the Space Lounge, up, and down from here.

(From here, you can move to north, northeast, northwest, southeast, west, up, and down.)

>wes
I didn't understand that sentence.

>west
Space Lounge
You are in the Space Lounge, rumored to be the center of The Resistance. "Why did I come here?" you briefly wonder before looking around.

You can see an airlock, a bar (on which are a glittery box (closed) and a Glowing Sphere), a chair, a bench, a bartender, a black ninja outfit, AFrame, and a Security bot here.

You can go east through the airlock to the Veranda Walkway from here.

(From here, you can move to east.)

>look at AFram
You can't see any such thing.

>look at Aframe
Aframe is looking pretty sharp there wearing a pin-striped suit with his usual aplomb.

>say hi
Whom do you want to say that to?

>say hi to Aframe
There is no reply.

>Aframe, hi
There is no reply.

>Aframe, Where am I?
There is no reply.

>Hit Aframe
Violence isn't the answer to this one.

>Tickle Aframe
I didn't understand that sentence.

>Aframe, Take off suit
He says "sure, anything for a laugh!"
AFrame takes off the pin-striped suit.

>look at AFrame
Aframe is looking pretty sharp there wearing a pink thong with his usual aplomb.

>Aframe, take off thong
He says "sure, anything for a laugh!"
AFrame takes off the pink thong.

>look at Aframe
Aframe is looking pretty sharp there wearing nothing with his usual aplomb.

>xx
I didn't understand that sentence.

I beg your pardon?

>Aframe, XX?
There is no reply.

>Aframe, xx
There is no reply.

>ask aframe xx
I didn't understand that sentence.

>Ask afram about xx
You can't see any such thing.

>Ask Afram about xx
You can't see any such thing.

>Ask Aframe about xx
When you mention xx, Aframe's eyes light up. He smiles and looks around the room for a second before stepping closer to you. "How do you know aobut xx?", he says - well it doesn't matter now - just remember yy when you get to the zz okay? DON'T FORGET ABOUT THE YY! Then he looks around again and slowly fades from view, like all the color faded to grey, then all the outlines of his features just slowly alpha-fade to zero.

>take thong
You can't see any such thing.

>look
Space Lounge
You are in the Space Lounge, rumored to be the center of The Resistance. "Why did I come here?" you briefly wonder before looking around.

You can see an airlock, a bar (on which are a glittery box (closed) and a Glowing Sphere), a chair, a bench, a bartender, a black ninja outfit, and a Security bot here.

You can go east through the airlock to the Veranda Walkway from here.

(From here, you can move to east.)

>take black ninja outfit
Taken.

>wear black ninja outfit
You are a ninja! It feels like you could blend into the shadows, or maybe you ARE the shadows, this ninja outfit makes you feel super ninja-like

>look
Space Lounge
You are in the Space Lounge, rumored to be the center of The Resistance. "Why did I come here?" you briefly wonder before looking around.

You can see an airlock, a bar (on which are a glittery box (closed) and a Glowing Sphere), a chair, a bench, a bartender, and a Security bot here.

You can go east through the airlock to the Veranda Walkway from here.

(From here, you can move to east.)

>look at Security Bot
Looks like a standard security bot.

>hit security bot
Violence isn't the answer to this one.

>look box
Time slows down, you feel as if you gazing into the cosmos itself. Your eyeballs can hardly stay on it, it's like your gaze just keeps sliding off.

* * *

>take readout
Taken.

>read readout
The screen is blank.

The security readout is currently switched off.

>turn out readout
I only understood you as far as wanting to turn outside.

>turn on readout
You switch the security readout on.

>read readout
The screen reads: 

 airlock (Space Lounge/Veranda Walkway): UNLOCKED

>look at security readout
The screen reads: 

 airlock (Space Lounge/Veranda Walkway): UNLOCKED

>take bowl
Taken.

>look at bowl
The bowl is kind of unremarkable, not really exciting like some cool crazy gun would be or something.

In the bowl is a note.

>take note
Taken.

* * *

>read note
Cast the secret spell xyzzy

>Cast xyzzy
You are unable to articulate the second "z" separately from the first, and the spell fails in a disdainful puff. If only you had some sort of magical item to focus your arcane arts upon to increase your attunement to the fey realm.

>take gun
You have no idea what this gun does. You've never seen anything like it! You're pretty stoked to get this gun.

Taken.

>point gun
I didn't understand that sentence.

>look at gun
That gun is so crazy looking! It's kind of like totally blowing your mind.

>shoot gun
What do you want to shoot the crazy looking gun at?

>shoot gun at security bot
ZAP! The Security bot twinkles out of existence!

>look
Space Lounge
You are in the Space Lounge, rumored to be the center of The Resistance. "Why did I come here?" you briefly wonder before looking around.

You can see an airlock, a bar (on which are a glittery box (empty) and a Glowing Sphere), a chair, a bench, and a bartender here.

You can go east through the airlock to the Veranda Walkway from here.

(From here, you can move to east.)

>look at sphere
OOOOoooo glowy-sphere thingie! Its purple soft glow makes you feel safe and secure. It looks like there's some sort of helix-key as a component to the glowy-ness but it's unclear how you would remove it.

>take sphere
That's fixed in place.

>cast xyzzy at sphere
I didn't understand that sentence.

>look bartender
The bartender is making a glow in the dark smoothie.

>Bartender Hello
I didn't understand that sentence.

>Bartender hi
I didn't understand that sentence.

>look
Space Lounge
You are in the Space Lounge, rumored to be the center of The Resistance. "Why did I come here?" you briefly wonder before looking around.

You can see an airlock, a bar (on which are a glittery box (empty) and a Glowing Sphere), a chair, a bench, and a bartender here.

You can go east through the airlock to the Veranda Walkway from here.

(From here, you can move to east.)

>look bartender
The bartender is serving some smoothies.

>look bartender
The bartender is talking with a friend.

>look bartender
The bartender is serving some smoothies.

>look bartender
The bartender is standing there looking you over.

>shoot bartender
(with the crazy looking gun)
The weird ray somehow seems to bend around the bartender and disperses into a cloud of neon-swirled rainbow shards. She looks at you with a strange smirky side-eye. She must be wearing some kind of personal ray-deflector device. "splick", you admire-think.

>east
Veranda Walkway
Outside the Space Lounge you look out into the larger Raditree Building to see the pool with under a high ceiling. Consuite lies beyond the pool in the main courtyard. Boffers beat each other up in the fenced in section of the courtyard. A floating dolphin surveillance pod floats by making you twitch instintively to make your shiny wig come between the camera and your face.

You can see an airlock, a black rod, and a floating dolphin (closed) here.

You can go north, northeast, northwest, southeast, west through the airlock to the Space Lounge, up, and down from here.

(From here, you can move to north, northeast, northwest, southeast, west, up, and down.)

>west
Space Lounge
You are in the Space Lounge, rumored to be the center of The Resistance. "Why did I come here?" you briefly wonder before looking around.

You can see an airlock, a bar (on which are a glittery box (empty) and a Glowing Sphere), a chair, a bench, and a bartender here.

You can go east through the airlock to the Veranda Walkway from here.

(From here, you can move to east.)

>sit bench
I didn't understand that sentence.

>sit ON bench
You get onto the bench.

>look
Space Lounge (on the bench)
You are in the Space Lounge, rumored to be the center of The Resistance. "Why did I come here?" you briefly wonder before looking around.

You can see an airlock, a bar (on which are a glittery box (empty) and a Glowing Sphere), a chair, and a bartender here.

You can go east through the airlock to the Veranda Walkway from here.

(From here, you can move to east.)

>lay on bench
I didn't understand that sentence.

>get off bench
You get off the bench.

Space Lounge
You are in the Space Lounge, rumored to be the center of The Resistance. "Why did I come here?" you briefly wonder before looking around.

You can see an airlock, a bar (on which are a glittery box (empty) and a Glowing Sphere), a chair, a bench, and a bartender here.

You can go east through the airlock to the Veranda Walkway from here.

(From here, you can move to east.)

>sit in chair
Oh boy this chair looks really soft and comfy! Ooooh ya you are totally gonna sit on this chair big time.

You sit down and are so comfortable - you could really get used to being in this chair. Really! Wowsers...it's just the comfiest thing you probably ever plopped yer can on...it's like you're almost part of this thing...like your skin is melding with it and your insides are turning to some sort of tiny little beans...or a kind of foam batting material...

"What a lovely soft and dreamy world", you think. Nothing is wrong and everything is right. Right and soft. Sooooo sooooofffft.

>get out of chair
I only understood you as far as wanting to get outside.

>stand up
You'd rather be asleep. Whatever other thing you would do besides being in this chair is a bad idea and not really that good of an option compared to being in this insanely comfy chair.

"What a lovely soft and dreamy world", you think. Nothing is wrong and everything is right. Right and soft. Sooooo sooooofffft.

>shoot chair
(with the crazy looking gun)
You'd rather be asleep. Whatever other thing you would do besides being in this chair is a bad idea and not really that good of an option compared to being in this insanely comfy chair.

"What a lovely soft and dreamy world", you think. Nothing is wrong and everything is right. Right and soft. Sooooo sooooofffft.

>help
Space Lounge (on the chair)
You are in the Space Lounge, rumored to be the center of The Resistance. "Why did I come here?" you briefly wonder before looking around.

You can see an airlock, a bar (on which are a glittery box (empty) and a Glowing Sphere), a bench, and a bartender here.

You can go east through the airlock to the Veranda Walkway from here.

(From here, you can move to east.)

>get off chair
You just can't get up, you are way too comfortable! Maybe if you just stayed here in this chair forever you would be better off than whatever else you were going to do. Does it really matter?

"What a lovely soft and dreamy world", you think. Nothing is wrong and everything is right. Right and soft. Sooooo sooooofffft.

* * *

>get off chair
You try to heave yourself up, but the soft lusciousness of the chair envelopes you and pulls you back into its comfy folds. Oooooo...so comfy...so sooooooofffffft...

"What a lovely soft and dreamy world", you think. Nothing is wrong and everything is right. Right and soft. Sooooo sooooofffft.

>get off chair
Whew! You just barely escaped that chair, it's so comfy you could get stuck in it forever!

>east
Veranda Walkway
Outside the Space Lounge you look out into the larger Raditree Building to see the pool with under a high ceiling. Consuite lies beyond the pool in the main courtyard. Boffers beat each other up in the fenced in section of the courtyard. A floating dolphin surveillance pod floats by making you twitch instintively to make your shiny wig come between the camera and your face.

You can see an airlock, a black rod, and a floating dolphin (closed) here.

You can go north, northeast, northwest, southeast, west through the airlock to the Space Lounge, up, and down from here.

(From here, you can move to north, northeast, northwest, southeast, west, up, and down.)

>look at rod
A three foot black rod with a rusty star on one end lies nearby.

>take rod
Taken.

>wave rod
You wave the black rod.

>shoot rod
(with the crazy looking gun)
ZAP! The black rod twinkles out of existence!

>shoot dolphin
(with the crazy looking gun)
ZAP! The floating dolphin twinkles out of existence!

>west
Space Lounge
You are in the Space Lounge, rumored to be the center of The Resistance. "Why did I come here?" you briefly wonder before looking around.

You can see an airlock, a bar (on which are a glittery box (empty) and a Glowing Sphere), a chair, a bench, and a bartender here.

You can go east through the airlock to the Veranda Walkway from here.

(From here, you can move to east.)

>shoot sphere
(with the crazy looking gun)
ZAP! The Glowing Sphere twinkles out of existence! The security key clatters to the ground!

* * *

>take key
Taken.

>look at key
This looks like a standard tetral-inverse double helix security key with triple-blind encryption. Probably used to access airlocks n-schtoff.

>east
Veranda Walkway
Outside the Space Lounge you look out into the larger Raditree Building to see the pool with under a high ceiling. Consuite lies beyond the pool in the main courtyard. Boffers beat each other up in the fenced in section of the courtyard. A floating dolphin surveillance pod floats by making you twitch instintively to make your shiny wig come between the camera and your face.

You can see an airlock here.

You can go north, northeast, northwest, southeast, west through the airlock to the Space Lounge, up, and down from here.

(From here, you can move to north, northeast, northwest, southeast, west, up, and down.)

>dow
I didn't understand that sentence.

>down
Under the Veranda Walkway
Under the Veranda Walkway

You can go north, northeast, southeast, east, west, and up to the Veranda Walkway from here.

(From here, you can move to north, northeast, southeast, east, west, and up.)

>west
Crescent Kitchen
Food and Beer for sale

You can go northeast and east to Under the Veranda Walkway from here.

(From here, you can move to northeast and east.)

>buy food
You can't see any such thing.

>buy beer
You can't see any such thing.

>northeast
Lower Floor Changer
Lower elevators, escalators and stairwell lower level

You can go north, northeast, northwest, south to Under the Veranda Walkway, southwest to Crescent Kitchen, west, and up from here.

(From here, you can move to north, northeast, northwest, south, southwest, west, and up.)

>south
Under the Veranda Walkway
Under the Veranda Walkway

You can go north to the Lower Floor Changer, northeast, southeast, east, west to Crescent Kitchen, and up to the Veranda Walkway from here.

(From here, you can move to north, northeast, southeast, east, west, and up.)

>east
Garden Court
Garden Court

You can go west to Under the Veranda Walkway from here.

(From here, you can move to west.)

>west
Under the Veranda Walkway
Under the Veranda Walkway

You can go north to the Lower Floor Changer, northeast, southeast, east to the Garden Court, west to Crescent Kitchen, and up to the Veranda Walkway from here.

(From here, you can move to north, northeast, southeast, east, west, and up.)

>up
Veranda Walkway
Outside the Space Lounge you look out into the larger Raditree Building to see the pool with under a high ceiling. Consuite lies beyond the pool in the main courtyard. Boffers beat each other up in the fenced in section of the courtyard. A floating dolphin surveillance pod floats by making you twitch instintively to make your shiny wig come between the camera and your face.

You can see an airlock here.

You can go north, northeast, northwest, southeast, west through the airlock to the Space Lounge, up, and down to Under the Veranda Walkway from here.

(From here, you can move to north, northeast, northwest, southeast, west, up, and down.)

>up
You don't have wings or pyscho-kinetic levitation abilities or a hoverboard or anything to go up with.

>shoot boffers
You can't see any such thing.

>north
Floor Changer
Elevators, escalators, and stairwell.

You can go northeast, northwest, south to the Veranda Walkway, east, west, and down to the Lower Floor Changer from here.

(From here, you can move to northeast, northwest, south, east, west, and down.)

>south
Veranda Walkway
Outside the Space Lounge you look out into the larger Raditree Building to see the pool with under a high ceiling. Consuite lies beyond the pool in the main courtyard. Boffers beat each other up in the fenced in section of the courtyard. A floating dolphin surveillance pod floats by making you twitch instintively to make your shiny wig come between the camera and your face.

You can see an airlock here.

You can go north to the Floor Changer, northeast, northwest, southeast, west through the airlock to the Space Lounge, up, and down to Under the Veranda Walkway from here.

(From here, you can move to north, northeast, northwest, southeast, west, up, and down.)

>southeast
Upper Southside Hallway
This hallway is NUTS - there are signs everywhere and lights and sounds flashing. From this hallway you can get into a bunch of Party Rooms

You can go north, northeast, northwest to the Veranda Walkway, south, southeast, and southwest from here.

(From here, you can move to north, northeast, northwest, south, southeast, and southwest.)

>southeast
Round1
Welcome to Trivia, I'm your host, the disembodied voice coming from your device. We have only one rule; please don't cheat. Questions will be simple this round being worth five points a piece, but will increase in both difficulty and value as the game goes on. 

You can go northwest to the Upper Southside Hallway from here.

(From here, you can move to northwest.)

Kim Jong Il, Joseph Stalin, or Mao Tsedong, which dictator ruled the longest?

Please enter your answer

>Mao Tsedong
Well done.  Next question.

According to the Old Testament, who spent 3 days and nights in the belly of a whale?

Please enter your answer

>Noah
Incorrect. Next question.

The Tom Green Show and 16 and Pregnant were originally aired on what network?

Please enter your answer

>MTV
Well done.  Next question.

The Soul and The Optima are both models by what auto make?

Please enter your answer

>Kia
That was Round One, now onto Round Two!

Round2
Now onto Round Two where the questions get slightly harder but are worth ten points a piece.

You can see no obvious exits.

(There are no routes out of this room.)

What movie has the Highland Games, a Witch, and Craig Ferguson as Lord Macintosh?

Please enter your answer

>Highlander
That was Round Two, now onto Round Three!

Round3
Round Three is here! The questions are harder but now worth fifteen points a piece.

You can see no obvious exits.

(There are no routes out of this room.)

Ebony and Ivory was a duet performed by Stevie Wonder and what former Beatle?

Please enter your answer

>John Lennon
That was Round Three, now onto Round Four!

Round4
This is it, the final round. Europe's The Final Countdown is now playing on loop in your head and the questions are worth a whopping twenty points a piece.

You can see no obvious exits.

(There are no routes out of this room.)

Double Think and Cold War are both terms created by what English Author?

Please enter your answer

>Douglas Adams
Incorrect. Next question.

What actor or actress was in X-Men the Last Stand, Inception, and Juno? 

Please enter your answer

>Mariah Carey
Incorrect. Next question.

Spteznaz is an umbrella term for special forces from what country?

Please enter your answer

>Russia
Well done.  Next question.

CVX is the stock ticker symbol for what energy giant?

Please enter your answer

>Convergence
Incorrect. That was the end of Round Four.

End
Final Score: 35/200

You can go northeast to the Upper Southside Hallway from here.

(From here, you can move to northeast.)

>i
You're carrying a quizinator2, a security key, a crazy looking gun, a note, a bowl, a security readout, and a coin. You're wearing a black ninja outfit and a wig.

[Your score has just gone up by thirty-five points.]

>look at quizinator2
You got this for bad quizinating.

>look
End
Final Score: 35/200

You can go northeast to the Upper Southside Hallway from here.

(From here, you can move to northeast.)

>northeast
Upper Southside Hallway
This hallway is NUTS - there are signs everywhere and lights and sounds flashing. From this hallway you can get into a bunch of Party Rooms

You can go north, northeast, northwest to the Veranda Walkway, south, southeast to the Round1, and southwest to the End from here.

(From here, you can move to north, northeast, northwest, south, southeast, and southwest.)

>restart
Are you sure you want to restart?

>yes
In the early 2000"s, mewonkind's folly led to the breakdown of society and the restructuring of general cultural and technological vector-goals. At least that's what you were taught in data-download segment 2-histori-political info part 27A while syncing the standard edu-packets back in school. Now though, you find yourself inside of the massive hive known as CONvergence.

N is one.

Today's magic number is boring.

X is eleven!

Splounge-Dystopia
Watch your back, and don't let the cams spy your face. by Aaron Prust
Release 1 / Serial number 171129 / Inform 7 build 6M62 (I6/v6.33 lib 6/12N) SD

Space Lounge
You are in the Space Lounge, rumored to be the center of The Resistance. "Why did I come here?" you briefly wonder before looking around.

You can see an airlock, a bar (on which are a glittery box (closed) and a Glowing Sphere), a chair, a bench, a bartender, a black ninja outfit, AFrame, and a Security bot here.

You can go east through the airlock (closed) from here.

>east
(first opening the airlock)

Veranda Walkway
Outside the Space Lounge you look out into the larger Raditree Building to see the pool with under a high ceiling. Consuite lies beyond the pool in the main courtyard. Boffers beat each other up in the fenced in section of the courtyard. A floating dolphin surveillance pod floats by making you twitch instintively to make your shiny wig come between the camera and your face.

You can see an airlock, a black rod, and a floating dolphin (closed) here.

You can go north, northeast, northwest, southeast, west through the airlock to the Space Lounge, up, and down from here.

>take rod
Taken.

>shoot rod
What do you want to shoot the black rod with?

>swing rod
There's nothing sensible to swing here.

>xyzzy rod
I only understood you as far as wanting to xyzzy.

>xyzzy at rod
I only understood you as far as wanting to xyzzy.

>cast xyzzy
you feel a whooshy sound enter your eyeball sockets and then your tummy flips over your groiny-place. WHOOOOOAAAA suddenly you find yourself trasported to the...

you feel a whooshy sound enter your eyeball sockets and then your tummy flips over your groiny-place. WHOOOOOAAAA suddenly you find yourself trasported to the...

Secret Room
You are in the Secret Room. DON'T TELL ANYONE YOU WERE EVER HERE! It's really dark, you can't see much.

You can see a dolphin code and a book here.

You can see no obvious exits.

(There are no routes out of this room.)

Under the influence of the black rod, you pronounced "xyzzy" as Xhi-zee. You understand now that the purpose of the black rod is to bring people here, to the Secret Room.

>look at book
"yzxxy" is the title, and the contents just say "Your Future Lies in Space" over and over again.

>look at code
It is fish shaped, and vibrates - readout screen says "Status optimal".

>take code
Taken.

>take book
Taken.

>eat fish
You can't see any such thing.

>eat code
That's plainly inedible.

>xyzzy
you feel a whooshy sound enter your eyeball sockets and then your tummy flips over your groiny-place. WHOOOOOAAAA suddenly you find yourself trasported to the...

you feel a whooshy sound enter your eyeball sockets and then your tummy flips over your groiny-place. WHOOOOOAAAA suddenly you find yourself trasported to the...

Secret Room
You are in the Secret Room. DON'T TELL ANYONE YOU WERE EVER HERE! It's really dark, you can't see much.

You can see no obvious exits.

(There are no routes out of this room.)

Under the influence of the black rod, you pronounced "xyzzy" as Xhi-zee. You understand now that the purpose of the black rod is to bring people here, to the Secret Room.

>read book
"yzxxy" is the title, and the contents just say "Your Future Lies in Space" over and over again.

>use code on book
I didn't understand that sentence.

>code book
I didn't understand that sentence.

>decode book
I didn't understand that sentence.

>shake code
I didn't understand that sentence.

>throw book
Dropped.

>pick up book
Taken.

>yzxxy
Space Lounge
You are in the Space Lounge, rumored to be the center of The Resistance. "Why did I come here?" you briefly wonder before looking around.

You can see an airlock, a bar (on which are a glittery box (closed) and a Glowing Sphere), a chair, a bench, a bartender, a black ninja outfit, AFrame, and a Security bot here.

You can go east through the airlock to the Veranda Walkway from here.

(From here, you can move to east.)

Under the influence of the black rod, you pronounced "yzxxy" as Wizex-zi. You are glad there is some way out of that Secret Room!

>open box
You open the glittery box, revealing a security readout, a bowl, and a crazy looking gun.

* * *

>take gun
You have no idea what this gun does. You've never seen anything like it! You're pretty stoked to get this gun.

Taken.

>ask aframe about xx
When you mention xx, Aframe's eyes light up. He smiles and looks around the room for a second before stepping closer to you. "How do you know aobut xx?", he says - well it doesn't matter now - just remember yy when you get to the zz okay? DON'T FORGET ABOUT THE YY! Then he looks around again and slowly fades from view, like all the color faded to grey, then all the outlines of his features just slowly alpha-fade to zero.

>xyzzy
you feel a whooshy sound enter your eyeball sockets and then your tummy flips over your groiny-place. WHOOOOOAAAA suddenly you find yourself trasported to the...

you feel a whooshy sound enter your eyeball sockets and then your tummy flips over your groiny-place. WHOOOOOAAAA suddenly you find yourself trasported to the...

Secret Room
You are in the Secret Room. DON'T TELL ANYONE YOU WERE EVER HERE! It's really dark, you can't see much.

You can see AFrame here.

You can see no obvious exits.

(There are no routes out of this room.)

Under the influence of the black rod, you pronounced "xyzzy" as Xhi-zee. You understand now that the purpose of the black rod is to bring people here, to the Secret Room.

>ask aframe about xx
When you mention xx, Aframe's eyes light up. He smiles and looks around the room for a second before stepping closer to you. "How do you know aobut xx?", he says - well it doesn't matter now - just remember yy when you get to the zz okay? DON'T FORGET ABOUT THE YY! Then he looks around again and slowly fades from view, like all the color faded to grey, then all the outlines of his features just slowly alpha-fade to zero.

>shoot aframe
(with the crazy looking gun)
This weird ray comes out of your gun but it's like it's moving in slow-motion...as the beam wiggles toward Aframe super duper slow he steps out of the way of it. The wiggling intensifies and disappears. Aframe is looking at you with this annoyed look. Like he doesn't totally trust you anymore because you just tried to twinkle him out of existence.

>ask aframe about xx
When you mention xx, Aframe's eyes light up. He smiles and looks around the room for a second before stepping closer to you. "How do you know aobut xx?", he says - well it doesn't matter now - just remember yy when you get to the zz okay? DON'T FORGET ABOUT THE YY! Then he looks around again and slowly fades from view, like all the color faded to grey, then all the outlines of his features just slowly alpha-fade to zero.

>restart
Are you sure you want to restart?

>yes
In the early 2000"s, mewonkind's folly led to the breakdown of society and the restructuring of general cultural and technological vector-goals. At least that's what you were taught in data-download segment 2-histori-political info part 27A while syncing the standard edu-packets back in school. Now though, you find yourself inside of the massive hive known as CONvergence.

N is more than the number of your toes.

Six is the magic number!

X is eleven!

Splounge-Dystopia
Watch your back, and don't let the cams spy your face. by Aaron Prust
Release 1 / Serial number 171129 / Inform 7 build 6M62 (I6/v6.33 lib 6/12N) SD

Space Lounge
You are in the Space Lounge, rumored to be the center of The Resistance. "Why did I come here?" you briefly wonder before looking around.

You can see an airlock, a bar (on which are a glittery box (closed) and a Glowing Sphere), a chair, a bench, a bartender, a black ninja outfit, AFrame, and a Security bot here.

You can go east through the airlock (closed) from here.

>open box
You open the glittery box, revealing a security readout, a bowl, and a crazy looking gun.

* * *

>open bo
You can't see any such thing.

>open box
You open the glittery box, revealing a security readout, a bowl, and a crazy looking gun.

* * *

>take gun
You have no idea what this gun does. You've never seen anything like it! You're pretty stoked to get this gun.

Taken.

>take note
Taken.

>take security
(the Security bot)
I don't suppose the Security bot would care for that.

>take security readout
Taken.

>look security readout
The screen is blank.

The security readout is currently switched off.

>turn on security readout
You switch the security readout on.

>look security readout
The screen reads: 

 airlock (Space Lounge/Veranda Walkway): LOCKED

>w
You can't go that way.

>look west
You see nothing unexpected in that direction.

>look
Space Lounge
You are in the Space Lounge, rumored to be the center of The Resistance. "Why did I come here?" you briefly wonder before looking around.

You can see an airlock, a bar (on which are a glittery box (in which is a bowl (empty)) and a Glowing Sphere), a chair, a bench, a bartender, a black ninja outfit, AFrame, and a Security bot here.

You can go east through the airlock (closed) from here.

(From here, you can move to east.)

>talk aframe
That's not a verb I recognize.

>aframe, hello
There is no reply.

>aframe, remove suit
He says "sure, anything for a laugh!"
AFrame takes off the pin-striped suit.

>ask aframe xx
I didn't understand that sentence.

* * *

>ask aframe about xx
When you mention xx, Aframe's eyes light up. He smiles and looks around the room for a second before stepping closer to you. "How do you know aobut xx?", he says - well it doesn't matter now - just remember yy when you get to the zz okay? DON'T FORGET ABOUT THE YY! Then he looks around again and slowly fades from view, like all the color faded to grey, then all the outlines of his features just slowly alpha-fade to zero.

>look
Space Lounge
You are in the Space Lounge, rumored to be the center of The Resistance. "Why did I come here?" you briefly wonder before looking around.

You can see an airlock, a bar (on which are a glittery box (in which is a bowl (empty)) and a Glowing Sphere), a chair, a bench, a bartender, a black ninja outfit, and a Security bot here.

You can go east through the airlock (closed) from here.

(From here, you can move to east.)

>shoot sphere with gun
ZAP! The Glowing Sphere twinkles out of existence! The security key clatters to the ground!

* * *

>take key
Taken.

>look
Space Lounge
You are in the Space Lounge, rumored to be the center of The Resistance. "Why did I come here?" you briefly wonder before looking around.

You can see an airlock, a bar (on which is a glittery box (in which is a bowl (empty))), a chair, a bench, a bartender, a black ninja outfit, and a Security bot here.

You can go east through the airlock (closed) from here.

(From here, you can move to east.)

>take ninja
Taken.

>security bot, follow me
There is no reply.

* * *

>open box
You open the glittery box, revealing a security readout, a bowl, and a crazy looking gun.

* * *

>w
Space Lounge
You are in the Space Lounge, rumored to be the center of The Resistance. "Why did I come here?" you briefly wonder before looking around.

You can see an airlock, a bar (on which is a glittery box (in which are a security readout and a bowl (in which is a note))), a chair, a bench, a bartender, and a black ninja costume here.

You can go east through the airlock to the Veranda Walkway from here.

(From here, you can move to east.)

>sit chair
I didn't understand that sentence.

* * *

>get up
You'd rather be asleep.

"What a lovely soft and dreamy world", you think. Nothing is wrong and everything is right. Right and soft. Sooooo sooooofffft.

>look
Space Lounge (on the chair)
You are in the Space Lounge, rumored to be the center of The Resistance. "Why did I come here?" you briefly wonder before looking around.

You can see an airlock, a bar (on which is a glittery box (in which are a security readout and a bowl (in which is a note))), a bench, a bartender, and a black ninja costume here.

You can go east through the airlock to the Veranda Walkway from here.

(From here, you can move to east.)

"What a lovely soft and dreamy world", you think. Nothing is wrong and everything is right. Right and soft. Sooooo sooooofffft.

>e
You'd rather be asleep.

"What a lovely soft and dreamy world", you think. Nothing is wrong and everything is right. Right and soft. Sooooo sooooofffft.

>get up from
What do you want to get up from?

>get up from chair
You just can't get up, you are way too comfortable!

"What a lovely soft and dreamy world", you think. Nothing is wrong and everything is right. Right and soft. Sooooo sooooofffft.

* * *

>get up from chair
"What a lovely soft and dreamy world", you think. Nothing is wrong and everything is right. Right and soft. Sooooo sooooofffft.

>stand up
You'd rather be asleep.

"What a lovely soft and dreamy world", you think. Nothing is wrong and everything is right. Right and soft. Sooooo sooooofffft.

>stand up
You'd rather be asleep.

"What a lovely soft and dreamy world", you think. Nothing is wrong and everything is right. Right and soft. Sooooo sooooofffft.

>get out of chair
I only understood you as far as wanting to get outside.

>get up from chair
Whew! You just barely escaped that chair, it's so comfy you could get stuck in it forever!

* * *

>take note
Taken.

>take readout
Taken.

>look readout
The screen is blank.

The security readout is currently switched off.

* * *

>turn on readout
You switch the security readout on.

>look readout
The screen reads: 

 airlock (Space Lounge/Veranda Walkway): LOCKED

>open airlock
(first unlocking the airlock)
You lack a key that fits the airlock.

>look
Space Lounge
You are in the Space Lounge, rumored to be the center of The Resistance. "Why did I come here?" you briefly wonder before looking around.

You can see an airlock, a bar (on which are a glittery box (in which is a bowl (empty)) and a Glowing Sphere), a chair, a bench, a bartender, and a black ninja costume here.

You can go east through the airlock (closed) from here.

(From here, you can move to east.)

>look sphere
OOOOoooo glowy-sphere thingie! Its purple soft glow makes you feel safe and secure. It looks like there's some sort of helix-key as a component to the glowy-ness but it's unclear how you would remove it.

>shoot sphere
(with the crazy looking gun)
ZAP! The Glowing Sphere twinkles out of existence! The security key clatters to the ground!

* * *

>take key
Taken.

>look
Space Lounge
You are in the Space Lounge, rumored to be the center of The Resistance. "Why did I come here?" you briefly wonder before looking around.

You can see an airlock, a bar (on which is a glittery box (in which is a bowl (empty))), a chair, a bench, a bartender, and a black ninja costume here.

You can go east through the airlock (closed) from here.

(From here, you can move to east.)

>take ninj
You can't see any such thing.

>take ninja
(the black ninja costume)
Taken.

>look bartender
You see a female bartender with neon hair and glowing robes serving drinks. The bartender is currently helping some other people but if you wait you can probably get a chance to talk to her.

>e
(first opening the airlock)
(first unlocking the airlock)
(with the security key)

Veranda Walkway
Outside the Space Lounge you look out into the larger Raditree Building to see the pool with under a high ceiling. Consuite lies beyond the pool in the main courtyard. Boffers beat each other up in the fenced in section of the courtyard. A floating dolphin surveillance pod floats by making you twitch instintively to make your shiny wig come between the camera and your face.

You can see an airlock, a black rod, and a floating dolphin (closed) here.

You can go north, northeast, northwest, southeast, west through the airlock to the Space Lounge, up, and down from here.

(From here, you can move to north, northeast, northwest, southeast, west, up, and down.)

>look dolphin
Oh crap - the floating dolphin's survellance cam is honing in on you! You better get out of here, somewhere where the floating dolphin camera can't see you.

>open dolphin
(first unlocking the floating dolphin)
You lack a key that fits the floating dolphin.

>look self
As good-looking as ever.

>i
You're carrying a black ninja costume, a security key, a security readout, a note, and a crazy looking gun. You're wearing a wig.

>look wig
This wig is super shiny and silvery, reflecting light off in all directions, it helps you avoid being face-detected by the intero-pods.

>take rod
Taken.

>xyzzy
you feel a whooshy sound enter your eyeball sockets and then your tummy flips over your groiny-place. WHOOOOOAAAA suddenly you find yourself trasported to the...

you feel a whooshy sound enter your eyeball sockets and then your tummy flips over your groiny-place. WHOOOOOAAAA suddenly you find yourself trasported to the...

Secret Room
You are in the Secret Room. DON'T TELL ANYONE YOU WERE EVER HERE! It's really dark, you can't see much.

You can see a dolphin code and a book here.

You can see no obvious exits.

(There are no routes out of this room.)

Under the influence of the black rod, you pronounced "xyzzy" as Xhi-zee. You understand now that the purpose of the black rod is to bring people here, to the Secret Room.

>look book
"yzxxy" is the title, and the contents just say "Your Future Lies in Space" over and over again.

>take code
Taken.

* * *

>take book
Taken.

>yzxxy
Space Lounge
You are in the Space Lounge, rumored to be the center of The Resistance. "Why did I come here?" you briefly wonder before looking around.

You can see an airlock, a bar (on which is a glittery box (in which is a bowl (empty))), a chair, a bench, and a bartender here.

You can go east through the airlock to the Veranda Walkway from here.

(From here, you can move to east.)

Under the influence of the black rod, you pronounced "yzxxy" as Wizex-zi. You are glad there is some way out of that Secret Room!

>e
Veranda Walkway
Outside the Space Lounge you look out into the larger Raditree Building to see the pool with under a high ceiling. Consuite lies beyond the pool in the main courtyard. Boffers beat each other up in the fenced in section of the courtyard. A floating dolphin surveillance pod floats by making you twitch instintively to make your shiny wig come between the camera and your face.

You can see an airlock and a floating dolphin (closed) here.

You can go north, northeast, northwest, southeast, west through the airlock to the Space Lounge, up, and down from here.

(From here, you can move to north, northeast, northwest, southeast, west, up, and down.)

>enter dolphin
(the dolphin code)
That's not something you can enter.

>open dolphin
(the dolphin code)
It isn't something you can open.

>open floathing dolphin
You can't see any such thing.

>open floatin dolphin
You can't see any such thing.

>open floating dolphin
(first unlocking the floating dolphin)
(with the dolphin code)
You open the floating dolphin.

* * *

>up
Floating Courtyard (in the floating dolphin)
The floating dolphin is transparent, but tints everything outside very faintly lavender.

This is amazing - you are up above everything and can see so much up here! There's a pool down below, and a fenced in courtyard with some kind of security gate system surrounding it, and Consuite.

You can go down to the Veranda Walkway from here.

(From here, you can move to down.)

>d
Veranda Walkway (in the floating dolphin)
The floating dolphin is transparent, but tints everything outside very faintly lavender.

Outside the Space Lounge you look out into the larger Raditree Building to see the pool with under a high ceiling. Consuite lies beyond the pool in the main courtyard. Boffers beat each other up in the fenced in section of the courtyard. A floating dolphin surveillance pod floats by making you twitch instintively to make your shiny wig come between the camera and your face.

You can see an airlock here.

You can go north, northeast, northwest, southeast, west through the airlock to the Space Lounge, up to the Floating Courtyard, and down from here.

(From here, you can move to north, northeast, northwest, southeast, west, up, and down.)

>se
Upper Southside Hallway (in the floating dolphin)
The floating dolphin is transparent, but tints everything outside very faintly lavender.

This hallway is NUTS - there are signs everywhere and lights and sounds flashing. From this hallway you can get into a bunch of Party Rooms

You can go north, northeast, northwest to the Veranda Walkway, and south from here.

(From here, you can move to north, northeast, northwest, and south.)

>ne
Consuite (in the floating dolphin)
The floating dolphin is transparent, but tints everything outside very faintly lavender.

You can go northwest, southwest to the Upper Southside Hallway, and down from here.

(From here, you can move to northwest, southwest, and down.)

>exit dolphin
I only understood you as far as wanting to exit.

>leave dolphin
I only understood you as far as wanting to leave.

>get out of floating dolphin
I only understood you as far as wanting to get outside.

>exit floating dolphin
I only understood you as far as wanting to exit.

>d
Under Consuite (in the floating dolphin)
The floating dolphin is transparent, but tints everything outside very faintly lavender.

Under Consuite

You can go northwest, southwest, west, and up to Consuite from here.

(From here, you can move to northwest, southwest, west, and up.)

>nw
Lower Northside Hallway (in the floating dolphin)
The floating dolphin is transparent, but tints everything outside very faintly lavender.

Lower Northside Hallway (party rooms)

You can go north, southeast to Under Consuite, and southwest from here.

(From here, you can move to north, southeast, and southwest.)

>sw
Under the Veranda Walkway (in the floating dolphin)
The floating dolphin is transparent, but tints everything outside very faintly lavender.

Under the Veranda Walkway

You can go north, northeast to Lower Northside Hallway, southeast, east, west, and up to the Veranda Walkway from here.

(From here, you can move to north, northeast, southeast, east, west, and up.)

>n
Lower Floor Changer (in the floating dolphin)
The floating dolphin is transparent, but tints everything outside very faintly lavender.

Lower elevators, escalators and stairwell lower level

You can go north, northeast, northwest, south to Under the Veranda Walkway, southwest, west, and up from here.

(From here, you can move to north, northeast, northwest, south, southwest, west, and up.)

>nw
Lower Tower Connector (in the floating dolphin)
The floating dolphin is transparent, but tints everything outside very faintly lavender.

The Lower Tower Connector - connection between the short and tall towers.

You can go southeast to the Lower Floor Changer from here.

(From here, you can move to southeast.)

>se
Lower Floor Changer (in the floating dolphin)
The floating dolphin is transparent, but tints everything outside very faintly lavender.

Lower elevators, escalators and stairwell lower level

You can go north, northeast, northwest to the Lower Tower Connector, south to Under the Veranda Walkway, southwest, west, and up from here.

(From here, you can move to north, northeast, northwest, south, southwest, west, and up.)

>n
Elevator Line (in the floating dolphin)
The floating dolphin is transparent, but tints everything outside very faintly lavender.

You are waiting for an elevator!

You can go south to the Lower Floor Changer from here.

(From here, you can move to south.)

>n
You can't go that way.

* * *

>security bot, hello
There is no reply.

>bartender, hello
There is no reply.

* * *

>sit chair
I didn't understand that sentence.

* * *

>get up
You'd rather be asleep.

"What a lovely soft and dreamy world", you think. Nothing is wrong and everything is right. Right and soft. Sooooo sooooofffft.

>stand
You'd rather be asleep.

"What a lovely soft and dreamy world", you think. Nothing is wrong and everything is right. Right and soft. Sooooo sooooofffft.

>stand
You'd rather be asleep.

"What a lovely soft and dreamy world", you think. Nothing is wrong and everything is right. Right and soft. Sooooo sooooofffft.

>get up
You'd rather be asleep.

"What a lovely soft and dreamy world", you think. Nothing is wrong and everything is right. Right and soft. Sooooo sooooofffft.

>get up from chair
You just can't get up, you are way too comfortable!

"What a lovely soft and dreamy world", you think. Nothing is wrong and everything is right. Right and soft. Sooooo sooooofffft.

* * *

>get up from chair
You just can't get up, you are way too comfortable!

"What a lovely soft and dreamy world", you think. Nothing is wrong and everything is right. Right and soft. Sooooo sooooofffft.

* * *

>get up from chair
Whew! You just barely escaped that chair, it's so comfy you could get stuck in it forever!

>sit chair
I didn't understand that sentence.

>sit on chair
Oh boy this chair looks really soft and comfy! Ooooh ya you are totally gonna sit on this chair big time.

"Hey Wait!" your subconscious jumps forth remembering the tempting softness - you decide not not to sit on that chair, it's so comfy you might never get up again!

>stand up
But you aren't in anything at the moment.

>sit on chair
Oh boy this chair looks really soft and comfy! Ooooh ya you are totally gonna sit on this chair big time.

"Hey Wait!" your subconscious jumps forth remembering the tempting softness - you decide not not to sit on that chair, it's so comfy you might never get up again!

>look chair
Watch out for that chair, it's so comfy you could get stuck in it forever!

>w
You can't go that way.

>look
Space Lounge
You are in the Space Lounge, rumored to be the center of The Resistance. "Why did I come here?" you briefly wonder before looking around.

You can see an airlock, a bar (on which are a glittery box (closed) and a Glowing Sphere), a chair, a bench, and a bartender here.

You can go east through the airlock (closed) from here.

(From here, you can move to east.)

* * *

>up
You don't have wings or pyscho-kinetic levitation abilities or a hoverboard or anything to go up with.

>down
Under the Veranda Walkway
Under the Veranda Walkway

You can go north, northeast, southeast, east, west, and up to the Veranda Walkway from here.

(From here, you can move to north, northeast, southeast, east, west, and up.)

>up
Veranda Walkway
Outside the Space Lounge you look out into the larger Raditree Building to see the pool with under a high ceiling. Consuite lies beyond the pool in the main courtyard. Boffers beat each other up in the fenced in section of the courtyard. A floating dolphin surveillance pod floats by making you twitch instintively to make your shiny wig come between the camera and your face.

You can see an airlock, a black rod, and a floating dolphin (closed) here.

You can go north, northeast, northwest, southeast, west through the airlock to the Space Lounge, up, and down to Under the Veranda Walkway from here.

(From here, you can move to north, northeast, northwest, southeast, west, up, and down.)

>se
Upper Southside Hallway
This hallway is NUTS - there are signs everywhere and lights and sounds flashing. From this hallway you can get into a bunch of Party Rooms

You can go north, northeast, and northwest to the Veranda Walkway from here.

(From here, you can move to north, northeast, and northwest.)

>n
Room 233
Room 233

You can go south to the Upper Southside Hallway from here.

(From here, you can move to south.)

>s
Upper Southside Hallway
This hallway is NUTS - there are signs everywhere and lights and sounds flashing. From this hallway you can get into a bunch of Party Rooms

You can go north to Room 233, northeast, and northwest to the Veranda Walkway from here.

(From here, you can move to north, northeast, and northwest.)

>nw
Veranda Walkway
Outside the Space Lounge you look out into the larger Raditree Building to see the pool with under a high ceiling. Consuite lies beyond the pool in the main courtyard. Boffers beat each other up in the fenced in section of the courtyard. A floating dolphin surveillance pod floats by making you twitch instintively to make your shiny wig come between the camera and your face.

You can see an airlock, a black rod, and a floating dolphin (closed) here.

You can go north, northeast, northwest, southeast to the Upper Southside Hallway, west through the airlock to the Space Lounge, up, and down to Under the Veranda Walkway from here.

(From here, you can move to north, northeast, northwest, southeast, west, up, and down.)

>se
Upper Southside Hallway
This hallway is NUTS - there are signs everywhere and lights and sounds flashing. From this hallway you can get into a bunch of Party Rooms

You can go north to Room 233, northeast, and northwest to the Veranda Walkway from here.

(From here, you can move to north, northeast, and northwest.)

>ne
Consuite
You can go northwest, southwest to the Upper Southside Hallway, and down from here.

(From here, you can move to northwest, southwest, and down.)

>sw
Upper Southside Hallway
This hallway is NUTS - there are signs everywhere and lights and sounds flashing. From this hallway you can get into a bunch of Party Rooms

You can go north to Room 233, northeast to Consuite, and northwest to the Veranda Walkway from here.

(From here, you can move to north, northeast, and northwest.)

* * *

>stand up chair
You just can't get up, you are way too comfortable! Maybe if you just stayed here in this chair forever you would be better off than whatever else you were going to do. Does it really matter?

"What a lovely soft and dreamy world", you think. Nothing is wrong and everything is right. Right and soft. Sooooo sooooofffft.

>stand up chair
You try to heave yourself up, but the soft lusciousness of the chair envelopes you and pulls you back into its comfy folds. Oooooo...so comfy...so sooooooofffffft...

"What a lovely soft and dreamy world", you think. Nothing is wrong and everything is right. Right and soft. Sooooo sooooofffft.

>stand up chair
Whew! You just barely escaped that chair, it's so comfy you could get stuck in it forever!

* * *

>sit on chair
Oh boy this chair looks really soft and comfy! Ooooh ya you are totally gonna sit on this chair big time.

You sit down and are so comfortable - you could really get used to being in this chair. Really! Wowsers...it's just the comfiest thing you probably ever plopped yer can on...it's like you're almost part of this thing...like your skin is melding with it and your insides are turning to some sort of tiny little beans...or a kind of foam batting material...

"What a lovely soft and dreamy world", you think. Nothing is wrong and everything is right. Right and soft. Sooooo sooooofffft.

>get off chair
You just can't get up, you are way too comfortable! Maybe if you just stayed here in this chair forever you would be better off than whatever else you were going to do. Does it really matter?

"What a lovely soft and dreamy world", you think. Nothing is wrong and everything is right. Right and soft. Sooooo sooooofffft.

>get off chair
You try to heave yourself up, but the soft lusciousness of the chair envelopes you and pulls you back into its comfy folds.

"What a lovely soft and dreamy world", you think. Nothing is wrong and everything is right. Right and soft. Sooooo sooooofffft.

>get off chair
"What a lovely soft and dreamy world", you think. Nothing is wrong and everything is right. Right and soft. Sooooo sooooofffft.

>get off chair
Whew! You just barely escaped that chair, it's so comfy you could get stuck in it forever!

>look
Space Lounge
You are in the Space Lounge, rumored to be the center of The Resistance. "Why did I come here?" you briefly wonder before looking around.

You can see an airlock, a bar (on which are a glittery box (closed) and a Glowing Sphere), a chair, a bench and a bartender here.

* * *

>get off chair
You just can't get up, you are way too comfortable! Maybe if you just stayed here in this chair forever you would be better off than whatever else you were going to do. Does it really matter?

"What a lovely soft and dreamy world", you think. Nothing is wrong and everything is right. Right and soft. Sooooo sooooofffft.

>stand up
You'd rather be asleep. Whatever other thing you would do besides being in this chair is a bad idea and not really that good of an option compared to being in this insanely comfy chair.

"What a lovely soft and dreamy world", you think. Nothing is wrong and everything is right. Right and soft. Sooooo sooooofffft.

>get up from chair
You try to heave yourself up, but the soft lusciousness of the chair envelopes you and pulls you back into its comfy folds. Oooooo...so comfy...so sooooooofffffft...

"What a lovely soft and dreamy world", you think. Nothing is wrong and everything is right. Right and soft. Sooooo sooooofffft.

>get up from chair
Whew! You just barely escaped that chair, it's so comfy you could get stuck in it forever!

* * *

>get up from chair
You just can't get up, you are way too comfortable! Maybe if you just stayed here in this chair forever you would be better off than whatever else you were going to do. Does it really matter?

"What a lovely soft and dreamy world", you think. Nothing is wrong and everything is right. Right and soft. Sooooo sooooofffft.

>get up crom chair
I only understood you as far as wanting to get up.

>get up from chair
You try to heave yourself up, but the soft lusciousness of the chair envelopes you and pulls you back into its comfy folds. Oooooo...so comfy...so sooooooofffffft...

"What a lovely soft and dreamy world", you think. Nothing is wrong and everything is right. Right and soft. Sooooo sooooofffft.

* * *

>get up from chair
Whew! You just barely escaped that chair, it's so comfy you could get stuck in it forever!

>sit on chair
Oh boy this chair looks really soft and comfy! Ooooh ya you are totally gonna sit on this chair big time.

Don't you remember the last time you were in that chair? It almost ATE YOU! What is your deal? Don't sit in this chair, it's too dangerous! You'd have to be like, a master of mental projection to sit on this chair without it's super soft comfy-ness obliterate you and subsume your soul.

* * *

>sit chair
I didn't understand that sentence.

>sit on chair
Oh boy this chair looks really soft and comfy! Ooooh ya you are totally gonna sit on this chair big time.

"Hey Wait!" your subconscious jumps forth remembering the tempting softness - you decide not not to sit on that chair, it's so comfy you might never get up again! It looks seriously comfy though...maybe just for a little tiny sliver of a moment you could get kinda comfy...

>sit on chair
Oh boy this chair looks really soft and comfy! Ooooh ya you are totally gonna sit on this chair big time.

"Hey Wait!" your subconscious jumps forth remembering the tempting softness - you decide not not to sit on that chair, it's so comfy you might never get up again! It looks seriously comfy though...maybe just for a little tiny sliver of a moment you could get kinda comfy...

* * *

>get up from chair
Whew! You just barely escaped that chair, it's so comfy you could get stuck in it forever!

>sit on chair
Oh boy this chair looks really soft and comfy! Ooooh ya you are totally gonna sit on this chair big time.

"Hey Wait!" your subconscious jumps forth remembering the tempting softness - you decide not not to sit on that chair, it's so comfy you might never get up again! It looks seriously comfy though...maybe just for a little tiny sliver of a moment you could get kinda comfy...

>sit on chair
Oh boy this chair looks really soft and comfy! Ooooh ya you are totally gonna sit on this chair big time.

Don't you remember the last time you were in that chair? It almost ATE YOU! What is your deal? Don't sit in this chair, it's too dangerous! You'd have to be like, a master of mental projection to sit on this chair without it's super soft comfy-ness obliterate you and subsume your soul.

* * *

>look
Space Lounge (on the chair)
You are in the Space Lounge, rumored to be the center of The Resistance. "Why did I come here?" you briefly wonder before looking around.

You can see an airlock, a bar (on which are a glittery box (closed) and a Glowing Sphere), a bench, a bartender, and a black ninja costume here.

You can go east through the airlock (closed) from here.

(From here, you can move to east.)

"What a lovely soft and dreamy world", you think. Nothing is wrong and everything is right. Right and soft. Sooooo sooooofffft.

>e
(first opening the airlock)
(first unlocking the airlock)
You'd rather be asleep. Whatever other thing you would do besides being in this chair is a bad idea and not really that good of an option compared to being in this insanely comfy chair.

"What a lovely soft and dreamy world", you think. Nothing is wrong and everything is right. Right and soft. Sooooo sooooofffft.

>e
(first opening the airlock)
(first unlocking the airlock)
You'd rather be asleep. Whatever other thing you would do besides being in this chair is a bad idea and not really that good of an option compared to being in this insanely comfy chair.

"What a lovely soft and dreamy world", you think. Nothing is wrong and everything is right. Right and soft. Sooooo sooooofffft.

* * *

>get up from chair
You just can't get up, you are way too comfortable! Maybe if you just stayed here in this chair forever you would be better off than whatever else you were going to do. Does it really matter?

"What a lovely soft and dreamy world", you think. Nothing is wrong and everything is right. Right and soft. Sooooo sooooofffft.

>look
Space Lounge (on the chair)
You are in the Space Lounge, rumored to be the center of The Resistance. "Why did I come here?" you briefly wonder before looking around.

You can see an airlock, a bar (on which are a glittery box (closed) and a Glowing Sphere), a bench, a bartender, and a black ninja costume here.

You can go east through the airlock (closed) from here.

(From here, you can move to east.)

"What a lovely soft and dreamy world", you think. Nothing is wrong and everything is right. Right and soft. Sooooo sooooofffft.

>look
Space Lounge (on the chair)
You are in the Space Lounge, rumored to be the center of The Resistance. "Why did I come here?" you briefly wonder before looking around.

You can see an airlock, a bar (on which are a glittery box (closed) and a Glowing Sphere), a bench, a bartender, and a black ninja costume here.

You can go east through the airlock (closed) from here.

(From here, you can move to east.)

"What a lovely soft and dreamy world", you think. Nothing is wrong and everything is right. Right and soft. Sooooo sooooofffft.

>get up from chair
You try to heave yourself up, but the soft lusciousness of the chair envelopes you and pulls you back into its comfy folds. Oooooo...so comfy...so sooooooofffffft...

"What a lovely soft and dreamy world", you think. Nothing is wrong and everything is right. Right and soft. Sooooo sooooofffft.

* * *

>sit on chair
Oh boy this chair looks really soft and comfy! Ooooh ya you are totally gonna sit on this chair big time.

"Hey Wait!" your subconscious jumps forth remembering the tempting softness - you decide not not to sit on that chair, it's so comfy you might never get up again! It looks seriously comfy though...maybe just for a little tiny sliver of a moment you could get kinda comfy...

>sit on chair
Oh boy this chair looks really soft and comfy! Ooooh ya you are totally gonna sit on this chair big time.

Don't you remember the last time you were in that chair? It almost ATE YOU! What is your deal? Don't sit in this chair, it's too dangerous! Only a master of mental projection could sit on this chair without its super soft comfy-ness obliterating and subsuming your soul to its dark desires (whatever they might be).

* * *

>look
Space Lounge (on the chair)
You are in the Space Lounge, rumored to be the center of The Resistance. "Why did I come here?" you briefly wonder before looking around.

You can see an airlock, a bar (on which are a glittery box (closed) and a Glowing Sphere), a bench, a bartender, and a black ninja costume here.

You can go east through the airlock (closed) from here.

(From here, you can move to east.)

"What a lovely soft and dreamy world", you think. Nothing is wrong and everything is right. Right and soft. Sooooo sooooofffft.

>open box
You'd rather be asleep. Besides glittery box is really far away, and you're so comfortable you don't really feel like moving.

"What a lovely soft and dreamy world", you think. Nothing is wrong and everything is right. Right and soft. Sooooo sooooofffft.

* * *

>open box
You'd rather be asleep.

"What a lovely soft and dreamy world", you think. Nothing is wrong and everything is right. Right and soft. Sooooo sooooofffft.

>look box
You'd rather be asleep.

"What a lovely soft and dreamy world", you think. Nothing is wrong and everything is right. Right and soft. Sooooo sooooofffft.

>get off chair
You just can't get up, you are way too comfortable!

"What a lovely soft and dreamy world", you think. Nothing is wrong and everything is right. Right and soft. Sooooo sooooofffft.

>get off chair
You try to heave yourself up, but the soft lusciousness of the chair envelopes you and pulls you back into its comfy folds.

"What a lovely soft and dreamy world", you think. Nothing is wrong and everything is right. Right and soft. Sooooo sooooofffft.

* * *

>get off chair
Whew! You just barely escaped that chair, it's so comfy you could get stuck in it forever!

>get off chair
You'd rather be asleep.

"What a lovely soft and dreamy world", you think. Nothing is wrong and everything is right. Right and soft. Sooooo sooooofffft.

>get off chair
You'd rather be asleep.

"What a lovely soft and dreamy world", you think. Nothing is wrong and everything is right. Right and soft. Sooooo sooooofffft.

* * *

>get off chair
Whew! You just barely escaped that chair, it's so comfy you could get stuck in it forever!

>open box
You open the glittery box, revealing a security readout, a bowl and a crazy looking gun.

>sit on chair
Oh boy this chair looks really soft and comfy! Ooooh ya you are totally gonna sit on that chair.

You decide not not to sit on that chair, it's so comfy you might never get up again!

>look
Space Lounge
You are in the Space Lounge, rumored to be the center of The Resistance. "Why did I come here?" you briefly wonder before looking around.

You can see an airlock, a bar (on which are a glittery box (in which are a security readout, a bowl (in which is a note) and a crazy looking gun) and a Glowing Sphere), a chair, a bench and a bartender here.

* * *

>sit on chair
Oh boy this chair looks really soft and comfy! Ooooh ya you are totally gonna sit on that chair.

You decide not not to sit on that chair, it's so comfy you might never get up again!

"What a lovely soft and dreamy world", you think. Nothing is wrong and everything is right. Right and soft. Sooooo sooooofffft.

>sit on bench
You are already sitting on bench.

"What a lovely soft and dreamy world", you think. Nothing is wrong and everything is right. Right and soft. Sooooo sooooofffft.

>get off chair
You just can't get up, you are way too comfortable!

"What a lovely soft and dreamy world", you think. Nothing is wrong and everything is right. Right and soft. Sooooo sooooofffft.

* * *

>get off chair
Whew! You just barely escaped that chair, it's so comfy you could get stuck in it forever!

>sit on bench
You get onto the bench.

>sit on chair
Oh boy this chair looks really soft and comfy! Ooooh ya you are totally gonna sit on that chair.

You decide not not to sit on that chair, it's so comfy you might never get up again!

>sit on chair
Oh boy this chair looks really soft and comfy! Ooooh ya you are totally gonna sit on that chair.

You decide not not to sit on that chair, it's so comfy you might never get up again!

* * *

>stand up
You'd rather be asleep. Whatever other thing you would do besides being in this chair is a bad idea and not really that good of an option compared to being in this insanely comfy chair.

"What a lovely soft and dreamy world", you think. Nothing is wrong and everything is right. Right and soft. Sooooo sooooofffft.

* * *

>take gun
You can't see any such thing.

* * *

>take gun
You have no idea what this gun does. You've never seen anything like it! You're pretty stoked to get this gun.

Taken.

>shoot aframe with gun
This weird ray comes out of your gun but it's like it's moving in slow-motion...as the beam wiggles toward Aframe super duper slow he steps out of the way of it. The wiggling intensifies and disappears. Aframe is looking at you with this annoyed look. Like he doesn't totally trust you anymore because you just tried to twinkle him out of existence.

>aframe, remove suit
He says "uhm I am not going to help you out because in case you forgot you tried to kill me. I don't even know why"

* * *

>take ninja
(the black ninja costume)
Taken.

>wear ninja
(the black ninja costume)
You are a ninja!

>look
Space Lounge
You are in the Space Lounge, rumored to be the center of The Resistance. "Why did I come here?" you briefly wonder before looking around.

You can see an airlock, a bar (on which are a glittery box (closed) and a Glowing Sphere), a chair, a bench, and a bartender here.

You can go east through the airlock (closed) from here.

(From here, you can move to east.)

* * *

>wear ninja
(the black ninja costume)
You are a ninja!

>look self
As good-looking as ever.

>i
You're empty-handed. You're wearing a black ninja costume and a wig.

>look ninja costume
The black ninja costume is kind of unremarkable, not really exciting like some cool crazy gun would be or something.

The black ninja costume's pocket contains a throwing star and a smoke bomb.

* * *

>look self
As good-looking as ever.

>look
Space Lounge
You are in the Space Lounge, rumored to be the center of The Resistance. "Why did I come here?" you briefly wonder before looking around.

You can see an airlock, a bar (on which are a glittery box (closed) and a Glowing Sphere), a chair, a bench, and a bartender here.

You can go east through the airlock (closed) from here.

(From here, you can move to east.)

* * *

>look self
As good-looking as ever.

>look ninja costume
The black ninja costume is kind of unremarkable, not really exciting like some cool crazy gun would be or something.

The black ninja costume's pocket contains a throwing star and a smoke bomb.

>take throwing star
Taken.

>take smoke bomb
Taken.

>look throwing star
The throwing star is kind of unremarkable, not really exciting like some cool crazy gun would be or something.

* * *

>take ninja outfit
Taken.

>wear ninja outfit
You are a ninja! It feels like you could blend into the shadows, or maybe you ARE the shadows, this ninja outfit makes you feel super ninja-like

>examine ninja outfit
This is a ninja outfit, it's black and has a hood that covers your face. It has pockets in it to store cool ninja gear. It has these sweet built in booties that muffle your footsteps as if you were a total ninja, which you totally are if you are wearing this outfit. You could sneak around a place with shadows without being detected if you were wearing this thing. You'd be so ninja.

The pocket contains nothing.

* * *

>wear ninja outfit
(first taking the black ninja outfit)
You are a ninja! It feels like you could blend into the shadows, or maybe you ARE the shadows, this ninja outfit makes you feel super ninja-like

>examine ninja outfit
This is a ninja outfit, it's black and has a hood that covers your face. It has pockets in it to store cool ninja gear. It has these sweet built in booties that muffle your footsteps as if you were a total ninja, which you totally are if you are wearing this outfit. You could sneak around a place with shadows without being detected if you were wearing this thing. You'd be so ninja.

The pocket contains nothing.

>examine ninja outfit
This is a ninja outfit, it's black and has a hood that covers your face. It has pockets in it to store cool ninja gear. It has these sweet built in booties that muffle your footsteps as if you were a total ninja, which you totally are if you are wearing this outfit. You could sneak around a place with shadows without being detected if you were wearing this thing. You'd be so ninja.

The pocket contains nothing.

* * *

>xyzzx
That's not a verb I recognise.

>cast xyzzx
I didn't understand that sentence.

>xyzzy
You are unable to articulate the second "z" separately from the first, and the spell fails in a disdainful puff. If only you had the black rod.

>take rod
Taken.

* * *

>xyzzy
You are unable to articulate the second "z" separately from the first, and the spell fails in a disdainful puff. If only you had the black rod.

>open box
You open the glittery box, revealing a security readout, a bowl and a crazy looking gun.

* * *

>take rod
Taken.

>xyzzy
you feel a whooshy sound enter your eyeball sockets and then your tummy flips over your groiny-place. WHOOOOOAAAA suddenly you find yourself trasported to the...

you feel a whooshy sound enter your eyeball sockets and then your tummy flips over your groiny-place. WHOOOOOAAAA suddenly you find yourself trasported to the...

Secret Room
You are in the Secret Room. DON'T TELL ANYONE YOU WERE EVER HERE! It's really dark, you can't see much.

Under the influence of the black rod, you pronounced "xyzzy" as Xhi-zee. You understand now that the purpose of the black rod is to bring people here, to the Secret Room.

>yzxxy
Space Lounge
You are in the Space Lounge, rumored to be the center of The Resistance. "Why did I come here?" you briefly wonder before looking around.

You can see an airlock, a bar (on which is a glittery box (in which are a security readout and a bowl (in which is a note))), a soft chair, a skate ramp technology chair, Many soft chairs and a bartender here.

Under the influence of the black rod, you pronounced "yzxxy" as Wizex-zi. You are glad there is some way out of that Secret Room!